啊	kbsk
啊	kbsk
阿	bskg
埃	fctd
挨	rctd
哎	kary
唉	kctd
哀	yeu
皑	rmnn
癌	ukkm
蔼	ayjn
矮	tdtv
艾	aru
碍	djgf
爱	epdc
隘	buwl
鞍	afpv
氨	rpvd
安	pvf
俺	wdjn
按	rpvg
暗	jujg
岸	mdfj
胺	epvg
案	pvsu
肮	eywn
昂	jqbj
盎	mdlf
凹	hnhg
敖	gqty
熬	gqto
翱	rdfn
袄	putd
傲	wgqt
奥	tmod
懊	ntmd
澳	itmd
芭	acb
捌	rkej
扒	rwy
叭	kwy
吧	kcn
笆	tcb
八	wty
疤	ucv
巴	cnhn
拔	rdcy
跋	khdy
靶	afcn
把	rcn
耙	fscn
坝	fmy
霸	fafe
罢	lfcu
爸	wrcb
白	rrrr
柏	srg
百	djf
摆	rlfc
佰	wdjg
败	mty
拜	rdfh
稗	trtf
斑	gygg
班	gytg
搬	rtuc
扳	rrcy
般	tuwc
颁	wvdm
板	srcy
版	thgc
扮	rwvt
拌	rugh
伴	wugh
瓣	urcu
半	ugk
办	ewi
绊	xugh
邦	dtbh
帮	dtbh
梆	sdtb
榜	syuy
膀	eyuy
绑	xdtb
棒	sdwg
磅	dyuy
蚌	jdhh
镑	qyuy
傍	wyuy
谤	yyuy
苞	aqnb
胞	eqnn
包	qnv
褒	ywke
剥	vijh
薄	aisf
雹	fqnb
保	wksy
堡	wksf
饱	qnqn
宝	pgyu
抱	rqnn
报	rbcy
暴	jawi
豹	eqyy
鲍	qgqn
爆	ojai
杯	sdhy
碑	drtf
悲	hdhn
卑	rtfj
北	uxn
辈	hdhl
背	uxef
贝	mhny
钡	qmy
倍	wukg
狈	qtmy
备	tlf
惫	tlnu
焙	oukg
被	puby
奔	dfaj
苯	asgf
本	sgd
笨	tsgf
崩	meef
绷	xeeg
甭	dhej
泵	diu
蹦	khme
迸	uapk
逼	gklp
鼻	thlj
比	xxn
鄙	kflb
笔	teb
彼	tby
碧	grdf
蓖	atlx
蔽	aitu
毕	xxfj
毙	xxgx
毖	xxnt
币	tmhk
庇	oxxv
痹	ulgj
闭	ufte
敝	ity
弊	itaj
必	nte
辟	nkuh
壁	nkuf
臂	nkue
避	nkup
陛	bxxf
鞭	afwr
边	epe
编	xyna
贬	mtpy
扁	ynma
便	wgjr
变	yocu
卞	yhu
辨	uytu
辩	uyuh
辫	uxuh
遍	ynmp
标	sfiy
彪	hwee
膘	esfi
表	geu
鳖	itqg
憋	itnu
别	kejh
瘪	uthx
彬	sset
斌	ygay
濒	ihhm
滨	iprw
宾	prwu
摈	rprw
兵	rwu
冰	uiy
柄	sgmw
丙	gmwi
秉	tvd
饼	qnua
炳	ogmw
病	ugmw
并	uaj
玻	gby
菠	aibu
播	rtol
拨	rnty
钵	qsgg
波	iby
博	fsfy
勃	fpbe
搏	rsfy
铂	qrg
箔	tirf
伯	wrg
帛	rmhj
舶	turg
脖	efpb
膊	esfy
渤	ifpe
泊	irg
驳	cgrr
捕	rsy
卜	hhy
哺	ksy
补	puhy
埠	ftnf
不	dhi
布	dmhj
步	hhr
簿	tisf
部	ukbh
怖	ndmh
擦	rpwi
猜	qtge
裁	faye
材	sftt
才	fte
财	mftt
睬	hesy
踩	khes
采	esu
彩	eset
菜	aesu
蔡	awfi
餐	hqcv
参	cder
蚕	gdju
残	gqga
惭	nlrh
惨	ncde
灿	omh
苍	awbb
舱	tuwb
仓	wbb
沧	iwbn
藏	aauh
操	rkks
糙	otfp
槽	sgmj
曹	gmaj
草	ajj
厕	dmjk
策	tsmb
侧	wmjh
册	mmgd
测	imjh
层	nfci
蹭	khuj
插	rtfe
叉	cyi
茬	adhf
茶	awsu
查	sjgf
碴	dsjg
搽	raws
察	pwfi
岔	wvmj
差	uaf
诧	ypta
拆	rryy
柴	hxsu
豺	eftt
搀	rqku
掺	rcde
蝉	jujf
馋	qnqu
谗	yqku
缠	xojf
铲	qutt
产	ute
阐	uujf
颤	ylkm
昌	jjf
猖	qtjj
场	fnrt
尝	ipfc
常	ipkh
长	tayi
偿	wipc
肠	enrt
厂	dgt
敞	imkt
畅	jhnr
唱	kjjg
倡	wjjg
超	fhvk
抄	ritt
钞	qitt
朝	fjeg
嘲	kfje
潮	ifje
巢	vjsu
吵	kitt
炒	oitt
车	lgnh
扯	rhg
撤	ryct
掣	tgmr
彻	tavt
澈	iyct
郴	ssbh
臣	ahnh
辰	dfei
尘	iff
晨	jdfe
忱	npqn
沉	ipwn
陈	baiy
趁	fhwe
衬	pufy
撑	ripr
称	tqiy
城	fdnn
橙	swgu
成	dnv
呈	kgf
乘	tuxv
程	tkgg
惩	tghn
澄	iwgu
诚	ydnn
承	bdii
逞	kgpd
骋	cgmn
秤	tguf
吃	ktnn
痴	utdk
持	rffy
匙	jghx
池	ibn
迟	nypi
弛	xbn
驰	cgbn
耻	bhg
齿	hwbj
侈	wqqy
尺	nyi
赤	fou
翅	fcnd
斥	ryi
炽	okwy
充	ycqb
冲	ukhh
虫	jhny
崇	mpfi
宠	pdxy
抽	rmg
酬	sgyh
畴	ldtf
踌	khdf
稠	tmfk
愁	tonu
筹	tdtf
仇	wvn
绸	xmfk
瞅	htoy
丑	nhgg
臭	thdu
初	puvt
出	bmk
橱	sdgf
厨	dgkf
躇	khaj
锄	qege
雏	qvwy
滁	ibws
除	bwgs
楚	ssnh
础	dbmh
储	wyfj
矗	fhfh
搐	ryxl
触	qejy
处	thi
揣	rmdj
川	kthh
穿	pwat
椽	sxey
传	wfny
船	tuwk
喘	kmdj
串	kkhk
疮	uwbv
窗	pwtq
幢	mhuf
床	osi
闯	ucgd
创	wbjh
吹	kqwy
炊	oqwy
捶	rtgf
锤	qtgf
垂	tgaf
春	dwjf
椿	sdwj
醇	sgyb
唇	dfek
淳	iybg
纯	xgbn
蠢	dwjj
戳	nwya
绰	xhjh
疵	uhxv
茨	auqw
磁	duxx
雌	hxwy
辞	tduh
慈	uxxn
瓷	uqwy
词	yngk
此	hxn
刺	smjh
赐	mjqr
次	uqwy
聪	bukn
葱	aqrn
囱	tlqi
匆	qryi
从	wwy
丛	wwgf
凑	udwd
粗	oegg
醋	sgaj
簇	tytd
促	wkhy
蹿	khph
篡	thdc
窜	pwkh
摧	rmwy
崔	mwyf
催	wmwy
脆	eqdb
瘁	uywf
粹	oywf
淬	iywf
翠	nywf
村	sfy
存	dhbd
寸	fghy
磋	duag
撮	rjbc
搓	ruag
措	rajg
挫	rwwf
错	qajg
搭	rawk
达	dpi
答	twgk
瘩	uawk
打	rsh
大	dddd
呆	ksu
歹	gqi
傣	wdwi
戴	falw
带	gkph
殆	gqck
代	wayy
贷	waym
袋	waye
待	tffy
逮	vipi
怠	cknu
耽	bpqn
担	rjgg
丹	myd
单	ujfj
郸	ujfb
掸	rujf
胆	ejgg
旦	jgf
氮	rooi
但	wjgg
惮	nujf
淡	iooy
诞	ythp
弹	xujf
蛋	nhju
当	ivf
挡	rivg
党	ipkq
荡	ainr
档	sivg
刀	vnt
捣	rqmh
蹈	khee
倒	wgcj
岛	qmk
祷	pydf
导	nfu
到	gcfj
稻	teeg
悼	nhjh
道	uthp
盗	uqwl
德	tfln
得	tjgf
的	rqyy
蹬	khwu
灯	osh
登	wgku
等	tffu
瞪	hwgu
凳	wgkw
邓	cbh
堤	fjgh
低	wqay
滴	iyud
迪	mpd
敌	tdty
笛	tmf
狄	qtoy
涤	itsy
翟	nwyf
嫡	vyud
抵	rqay
底	oqay
地	fbn
蒂	ayuh
第	txht
帝	yuph
弟	uxht
递	uxhp
缔	xyuh
颠	fhwm
掂	rohk
滇	ifhw
碘	dmaw
点	hkou
典	mawu
靛	geph
垫	rvyf
电	jnv
佃	wlg
甸	qld
店	ohkd
惦	nohk
奠	usgd
淀	ipgh
殿	nawc
碉	dmfk
叼	kngg
雕	mfky
凋	umfk
刁	ngd
掉	rhjh
吊	kmhj
钓	qqyy
调	ymfk
跌	khtg
爹	wrqq
碟	dans
蝶	jans
迭	tgpi
谍	yans
叠	cccg
丁	sgh
盯	hsh
叮	ksh
钉	qsh
顶	sdmy
鼎	hndn
锭	qpgh
定	pghu
订	ysh
丢	tfcu
东	aii
冬	tuu
董	atgf
懂	natf
动	fcet
栋	saiy
侗	wmgk
恫	nmgk
冻	uaiy
洞	imgk
兜	rqnq
抖	rufh
斗	ufk
陡	bfhy
豆	gkuf
逗	gkup
痘	ugku
都	ftjb
督	hich
毒	gxu
犊	cfnd
独	qtjy
读	yfnd
堵	fftj
睹	hftj
赌	mftj
杜	sfg
镀	qoac
肚	efg
度	oaci
渡	ioac
妒	vynt
端	umdj
短	tdgu
锻	qthc
段	thdc
断	onrh
缎	xthc
堆	fwyg
兑	ukqb
队	bwy
对	cfy
墩	fybt
吨	kgbn
蹲	khuf
敦	ybty
顿	gbnm
囤	lgbn
钝	qgbn
盾	rfhd
遁	rfhp
掇	rccc
哆	kqqy
多	qqu
夺	dfu
垛	fwsy
躲	tmds
朵	wsu
跺	khws
舵	tupx
剁	wsjh
惰	ndae
堕	bdef
蛾	jtry
峨	mtry
鹅	trng
俄	wtry
额	ptkm
讹	ywxn
娥	vtry
恶	gonu
厄	dbv
扼	rdbn
遏	jqwp
鄂	kkfb
饿	qnty
恩	ldnu
而	dmjj
儿	qtn
耳	bghg
尔	qiu
饵	qnbg
洱	ibg
二	fgg
贰	afmy
发	ntcy
罚	lyjj
筏	twau
伐	way
乏	tpu
阀	uwai
法	ifcy
珐	gfcy
藩	aitl
帆	mhwy
番	tolf
翻	toln
樊	srrd
矾	dwyy
钒	qwyy
繁	txti
凡	wyi
烦	odmy
反	rci
返	rcpi
范	aibb
贩	mrcy
犯	qtbn
饭	qnrc
泛	itpy
坊	fyt
芳	ayr
方	yygt
肪	eyt
房	ynye
防	byt
妨	vyt
仿	wyt
访	yyt
纺	xyt
放	yty
菲	ahdd
非	hdhd
啡	khdd
飞	nui
肥	ecn
匪	ahdd
诽	yhdd
吠	kdy
肺	egmh
废	onty
沸	ixjh
费	xjmu
芬	awvr
酚	sgwv
吩	kwvt
氛	rwve
分	wvr
纷	xwvt
坟	fyy
焚	ssou
汾	iwvt
粉	owvt
奋	dlf
份	wwvt
忿	wvnu
愤	nfam
粪	oawu
丰	dhk
封	fffy
枫	swry
蜂	jtdh
峰	mtdh
锋	qtdh
风	wri
疯	uwri
烽	otdh
逢	tdhp
冯	ucgg
缝	xtdp
讽	ywry
奉	dwgj
凤	wci
佛	wxjh
否	dhkf
夫	gggy
敷	syty
肤	egy
孵	qytb
扶	rgy
拂	rxjh
辐	lgkl
幅	mhgl
氟	rxjk
符	twfu
伏	wdy
俘	webg
服	ebcy
浮	iebg
涪	iukg
福	pygl
袱	puwd
弗	xjk
甫	sghy
抚	rfqn
辅	lsy
俯	wowf
釜	wrfu
斧	wrrj
脯	esy
腑	eowf
府	owfi
腐	owfw
赴	fhhi
副	gklj
覆	sttt
赋	mgay
复	tjtu
傅	wsfy
付	wfy
阜	tnfj
父	wru
腹	etjt
负	qmu
富	pgkl
讣	yhy
附	bwfy
妇	vvg
缚	xsfy
咐	kwfy
噶	kajn
嘎	kdha
该	yynw
改	nty
概	svaq
钙	qghn
盖	uglf
溉	ivaq
干	fggh
甘	fghg
杆	sfh
柑	sfg
竿	tfj
肝	efh
赶	fhfk
感	dgkn
秆	tfh
敢	nbty
赣	ujtm
冈	mri
刚	mrjh
钢	qmry
缸	tfba
肛	eag
纲	xmry
岗	mmru
港	iawn
杠	sag
篙	tymk
皋	rdfj
高	ymkf
膏	ypke
羔	ugou
糕	ougo
搞	rymk
镐	qymk
稿	tymk
告	tfkf
哥	sksk
歌	sksw
搁	rutk
戈	agny
鸽	wgkg
胳	etkg
疙	utnv
割	pdhj
革	afj
葛	ajqn
格	stkg
蛤	jwgk
阁	utkd
隔	bgkh
铬	qtkg
个	whj
各	tkf
给	xwgk
根	svy
跟	khvy
耕	fsfj
更	gjri
庚	ovwi
羹	ugod
埂	fgjr
耿	boy
梗	sgjr
工	aaaa
攻	aty
功	aet
恭	awnu
龚	dxyw
供	wawy
躬	tmdx
公	wcu
宫	pkkf
弓	xngn
巩	awyy
汞	aiu
拱	rawy
贡	amu
共	awu
钩	qqcy
勾	qci
沟	iqcy
苟	aqkf
狗	qtqk
垢	frgk
构	sqcy
购	mqcy
够	qkqq
辜	duj
菇	avdf
咕	kdg
箍	trah
估	wdg
沽	idg
孤	brcy
姑	vdg
鼓	fkuc
古	dghg
蛊	jlf
骨	mef
谷	wwkf
股	ewcy
故	dty
顾	dbdm
固	ldd
雇	ynwy
刮	tdjh
瓜	rcyi
剐	kmwj
寡	pdev
挂	rffg
褂	pufh
乖	tfux
拐	rket
怪	ncfg
棺	spng
关	udu
官	pnf
冠	pfqf
观	cmqn
管	tpnf
馆	qnpn
罐	tfby
惯	nxmy
灌	iaky
贯	xmu
光	igqb
广	oygt
逛	qtgp
瑰	grqc
规	gmqn
圭	fff
硅	dffg
归	jvg
龟	qjnb
闺	uffd
轨	lvn
鬼	rqci
诡	yqdb
癸	wgdu
桂	sffg
柜	sang
跪	khqb
贵	khgm
刽	wfcj
辊	ljxx
滚	iuce
棍	sjxx
锅	qkmw
郭	ybbh
国	lgyi
果	jsi
裹	yjse
过	fpi
哈	kwgk
骸	meyw
孩	bynw
海	itxy
氦	rynw
亥	yntw
害	pdhk
骇	cgyw
酣	sgfg
憨	nbtn
邯	fbh
韩	fjfh
含	wynk
涵	ibib
寒	pawu
函	bibk
喊	kdgk
罕	pwfj
翰	fjwn
撼	rdgn
捍	rjfh
旱	jfj
憾	ndgn
悍	njfh
焊	ojfh
汗	ifh
汉	icy
夯	der
杭	sywn
航	tuyw
壕	fype
嚎	kype
豪	ypge
毫	ypeb
郝	fobh
好	vbg
耗	fsen
号	kgnb
浩	itfk
呵	kskg
喝	kjqn
荷	awsk
菏	aisk
核	synw
禾	tttt
和	tkg
何	wskg
合	wgkf
盒	wgkl
貉	etkg
阂	uynw
河	iskg
涸	ildg
赫	fofo
褐	pujn
鹤	pwyg
贺	ekmu
嘿	klfo
黑	lfou
痕	uvi
很	tvy
狠	qtvy
恨	nvy
哼	kybh
亨	ybj
横	samw
衡	tqds
恒	ngjg
轰	lccu
哄	kawy
烘	oawy
虹	jag
鸿	iaqg
洪	iawy
宏	pdcu
弘	xcy
红	xag
喉	kwnd
侯	wntd
猴	qtwd
吼	kbnn
厚	djbd
候	whnd
后	rgkd
呼	ktuf
乎	tufk
忽	qrnu
瑚	gdeg
壶	fpof
葫	adef
胡	deg
蝴	jdeg
狐	qtry
糊	odeg
湖	ideg
弧	xrcy
虎	hwv
唬	khwn
护	rynt
互	gxd
沪	iynt
户	yne
花	awxb
哗	kwxf
华	wxfj
猾	qtme
滑	imeg
画	glbj
划	ajh
化	wxn
话	ytdg
槐	srqc
徊	tlkg
怀	ndhy
淮	iwyg
坏	fdhy
欢	cqwy
环	gdhy
桓	sgjg
还	dhpi
缓	xegc
换	rqmd
患	kkhn
唤	kqmd
痪	uqmd
豢	ugge
焕	oqmd
涣	iqmd
宦	pahh
幻	xnn
荒	aynk
慌	nayk
黄	amwu
磺	damw
蝗	jrgg
簧	tamw
皇	rgf
凰	wrgd
惶	nrgg
煌	orgg
晃	jigq
幌	mhjq
恍	nigq
谎	yayk
灰	dou
挥	rplh
辉	igql
徽	tmgt
恢	ndoy
蛔	jlkg
回	lkd
毁	eawc
悔	ntxy
慧	dhdn
卉	faj
惠	gjhn
晦	jtxy
贿	mdeg
秽	tmqy
会	wfcu
烩	owfc
汇	ian
讳	yfnh
诲	ytxy
绘	xwfc
荤	aplj
昏	qajf
婚	vqaj
魂	fcrc
浑	iplh
混	ijxx
豁	pdhk
活	itdg
伙	woy
火	oooo
获	aqtd
或	akgd
惑	akgn
霍	fwyf
货	wxmu
祸	pykw
击	gbk
圾	fbyy
基	dwff
机	swn
畸	ldsk
稽	tdnj
积	tkwy
箕	tdwu
肌	ewn
饥	qnwn
迹	yopi
激	iryt
讥	ywn
鸡	cqgg
姬	vahh
绩	xgmy
缉	xkbg
吉	fkf
极	sbyy
棘	smsm
辑	lkbg
籍	tfsj
集	wysu
及	byi
急	qvnu
疾	utdi
汲	ibyy
即	vbh
嫉	vutd
级	xbyy
挤	ryjh
几	wtn
脊	iwef
己	nngn
蓟	aqgj
技	rfcy
冀	uxlw
季	tbf
伎	wfcy
祭	wfiu
剂	yjjh
悸	ntbg
济	iyjh
寄	pdsk
寂	phic
计	yfh
记	ynn
既	vaqn
忌	nnu
际	bfiy
妓	vfcy
继	xonn
纪	xnn
嘉	fkuk
枷	sekg
夹	gudi
佳	wffg
家	pgeu
加	ekg
荚	agud
颊	gudm
贾	smu
甲	lhnh
钾	qlh
假	wnhc
稼	tpge
价	wwjh
架	eksu
驾	ekcg
嫁	vpge
歼	gqtf
监	jtyl
坚	jcff
尖	idu
笺	tgau
间	ujd
煎	uejo
兼	uvjw
肩	yned
艰	cvy
奸	vfh
缄	xdgk
茧	aju
检	swgg
柬	sld
碱	ddgk
硷	dwgg
拣	ranw
捡	rwgg
简	tujf
俭	wwgg
剪	uejv
减	udgk
荐	adhb
槛	sjtl
鉴	jtyq
践	khga
贱	mgay
见	mqb
键	qvgp
箭	tuej
件	wtgh
健	wvgp
舰	tumq
剑	wgij
饯	qnga
渐	ilrh
溅	imga
涧	iujg
建	vgpk
僵	wglg
姜	ugvf
将	uqfy
浆	uqiu
江	iag
疆	xfgg
蒋	auqf
桨	uqsu
奖	uqdu
讲	yfjh
匠	ark
酱	uqsg
降	btgh
蕉	awyo
椒	shic
礁	dwyo
焦	wyou
胶	eury
交	uru
郊	urbh
浇	iatq
骄	cgtj
娇	vtdj
嚼	kelf
搅	ripq
铰	qury
矫	tdtj
侥	watq
脚	efcb
狡	qtur
角	qej
饺	qnur
缴	xryt
绞	xury
剿	vjsj
教	ftbt
酵	sgfb
轿	ltdj
较	lury
叫	knhh
窖	pwtk
揭	rjqn
接	ruvg
皆	xxrf
秸	tfkg
街	tffs
阶	bwjh
截	fawy
劫	fcet
节	abj
桔	sfkg
杰	sou
捷	rgvh
睫	hgvh
竭	ujqn
洁	ifkg
结	xfkg
解	qevg
姐	vegg
戒	aak
藉	afsj
芥	awjj
界	lwjj
借	wajg
介	wjj
疥	uwjk
诫	yaah
届	nmd
巾	mhk
筋	teer
斤	rtth
金	qqqq
今	wynb
津	ivgh
襟	pusi
紧	jcxi
锦	qrmh
仅	wcy
谨	yakg
进	fjpk
靳	afrh
晋	gojf
禁	ssfi
近	rpk
烬	onyu
浸	ivpc
尽	nyuu
劲	caet
荆	agaj
兢	dqdq
茎	acaf
睛	hgeg
晶	jjjf
鲸	qgyi
京	yiu
惊	nyiy
精	ogeg
粳	ogjr
经	xcag
井	fjk
警	aqky
景	jyiu
颈	cadm
静	geqh
境	fujq
敬	aqkt
镜	qujq
径	tcag
痉	ucad
靖	ugeg
竟	ujqb
竞	ukqb
净	uqvh
炯	omkg
窘	pwvk
揪	rtoy
究	pwvb
纠	xnhh
玖	gqyy
韭	hdhg
久	qyi
灸	qyou
九	vtn
酒	isgg
厩	dvaq
救	giyt
旧	hjg
臼	ethg
舅	eler
咎	thkf
就	yidy
疚	uqyi
鞠	afqo
拘	rqkg
狙	qteg
疽	uegd
居	ndd
驹	cgqk
菊	aqou
局	nnkd
咀	kegg
矩	tdan
举	igwg
沮	iegg
聚	bciu
拒	rang
据	rndg
巨	and
具	hwu
距	khan
踞	khnd
锯	qndg
俱	whwy
句	qkd
惧	nhwy
炬	oang
剧	ndjh
捐	rkeg
鹃	keqg
娟	vkeg
倦	wugb
眷	ughf
卷	ugbb
绢	xkeg
撅	rduw
攫	rhhc
抉	rnwy
掘	rnbm
倔	wnbm
爵	elvf
觉	ipmq
决	unwy
诀	ynwy
绝	xqcn
均	fqug
菌	altu
钧	qqug
军	plj
君	vtkf
峻	mcwt
俊	wcwt
竣	ucwt
浚	icwt
郡	vtkb
骏	cgct
喀	kptk
咖	kekg
卡	hhu
咯	ktkg
开	gak
揩	rxxr
楷	sxxr
凯	mnwn
慨	nvaq
刊	fjh
堪	fdwn
勘	dwne
坎	fqwy
砍	dqwy
看	rhf
康	ovii
慷	novi
糠	oovi
扛	rag
抗	rywn
亢	ywb
炕	oywn
考	ftgn
拷	rftn
烤	oftn
靠	tfkd
坷	fskg
苛	askf
柯	sskg
棵	sjsy
磕	dfcl
颗	jsdm
科	tufh
壳	fpwb
咳	kynw
可	skd
渴	ijqn
克	dqb
刻	yntj
客	ptkf
课	yjsy
肯	hef
啃	kheg
垦	vff
恳	vnu
坑	fywn
吭	kywn
空	pwaf
恐	awyn
孔	bnn
控	rpwa
抠	rary
口	kkkk
扣	rkg
寇	pfqc
枯	sdg
哭	kkdu
窟	pwnm
苦	adf
酷	sgtk
库	olk
裤	puol
夸	dfnb
垮	fdfn
挎	rdfn
跨	khdn
胯	edfn
块	fnwy
筷	tnnw
侩	wwfc
快	nnwy
宽	pamq
款	ffiw
匡	agd
筐	tagf
狂	qtgg
框	sagg
矿	dot
眶	hagg
旷	jot
况	ukqn
亏	fnb
盔	dolf
岿	mjvf
窥	pwgq
葵	awgd
奎	dfff
魁	rqcf
傀	wrqc
馈	qnkm
愧	nrqc
溃	ikhm
坤	fjhh
昆	jxxb
捆	rlsy
困	lsi
括	rtdg
扩	rot
廓	oybb
阔	uitd
垃	fug
拉	rug
喇	kskj
蜡	jajg
腊	eajg
辣	uskg
啦	krug
莱	agus
来	gusi
赖	skqm
蓝	ajtl
婪	ssvf
栏	sudg
拦	rudg
篮	tjtl
阑	usld
兰	udf
澜	iusl
谰	yusl
揽	rjtq
览	jtyq
懒	nskm
缆	xjtq
烂	oudg
滥	ijtl
琅	gyvy
榔	syvb
狼	qtyv
廊	oyvb
郎	yvbh
朗	yveg
浪	iyvy
捞	rape
劳	aper
牢	ptgj
老	ftxb
佬	wftx
姥	vftx
酪	sgtk
烙	otkg
涝	iape
勒	afet
乐	tnii
雷	flf
镭	qflg
蕾	aflf
磊	dddf
累	lxiu
儡	wlll
垒	cccf
擂	rflg
肋	eet
类	odu
泪	ihg
棱	sfwt
楞	slyt
冷	uwyc
厘	djfd
梨	tjsu
犁	tjtg
黎	tqti
篱	tyrc
狸	qtjf
离	yrbc
漓	iyrc
理	gjfg
李	sbf
里	jfd
鲤	qgjf
礼	pynn
莉	atjj
荔	aeee
吏	gkri
栗	ssu
丽	gmyy
厉	dgqe
励	dgqe
砾	dtni
历	dee
利	tjh
傈	wssy
例	wgqj
俐	wtjh
痢	utjk
立	uuuu
粒	oug
沥	idet
隶	vii
力	ent
璃	gyrc
哩	kjfg
俩	wgmw
联	budy
莲	alpu
连	lpk
镰	qouw
廉	ouvw
怜	nwyc
涟	ilpy
帘	pwmh
敛	wgit
脸	ewgg
链	qlpy
恋	yonu
炼	oanw
练	xanw
粮	oyvy
凉	uyiy
梁	ivws
粱	ivwo
良	yvi
两	gmww
辆	lgmw
量	jgjf
晾	jyiy
亮	ypwb
谅	yyiy
撩	rdui
聊	bqtb
僚	wdui
疗	ubk
燎	odui
寥	pnwe
辽	bpk
潦	idui
了	bnh
撂	rltk
镣	qdui
廖	onwe
料	oufh
列	gqjh
裂	gqje
烈	gqjo
劣	iter
猎	qtaj
琳	gssy
林	ssy
磷	doqg
霖	fssu
临	jtyj
邻	wycb
鳞	qgog
淋	issy
凛	uyli
赁	wtfm
吝	ykf
拎	rwyc
玲	gwyc
菱	afwt
零	fwyc
龄	hwbc
铃	qwyc
伶	wwyc
羚	uwyc
凌	ufwt
灵	vou
陵	bfwt
岭	mwyc
领	wycm
另	ker
令	wycu
溜	iqyl
琉	gyck
榴	sqyl
硫	dyck
馏	qnql
留	qyvl
刘	yjh
瘤	uqyl
流	iyck
柳	sqtb
六	uygy
龙	dxyi
聋	dxyb
咙	kdxy
笼	tdxy
窿	pwbg
隆	btgg
垄	dxyf
拢	rdxy
陇	bdxy
楼	sovg
娄	ovf
搂	rovg
篓	tovf
漏	infy
陋	bgmn
芦	aynr
卢	hnr
颅	hndm
庐	oyne
炉	oynt
掳	rhet
卤	hlru
虏	hee
鲁	qgjf
麓	ssox
碌	dviy
露	fkhk
路	khtk
赂	mtkg
鹿	oxxv
潞	ikhk
禄	pyvi
录	viu
陆	bgbh
戮	nwea
驴	cgyn
吕	kkf
铝	qkkg
侣	wkkg
旅	ytey
履	nttt
屡	novd
缕	xovg
虑	hni
氯	rvii
律	tvgh
率	yxif
滤	ihny
绿	xviy
峦	yomj
挛	yorj
孪	yobf
滦	iyos
卵	qyty
乱	tdnn
掠	ryiy
略	ltkg
抡	rwxn
轮	lwxn
伦	wwxn
仑	wxb
沦	iwxn
纶	xwxn
论	ywxn
萝	alqu
螺	jlxi
罗	lqu
逻	lqpi
锣	qlqy
箩	tlqu
骡	cgli
裸	pujs
落	aitk
洛	itkg
骆	cgtk
络	xtkg
妈	vcgg
麻	ossi
玛	gcgg
码	dcgg
蚂	jcgg
马	cgd
骂	kkcg
嘛	koss
吗	kcgg
埋	fjfg
买	nudu
麦	gtu
卖	fnud
迈	gqpe
脉	eyni
瞒	hagw
馒	qnjc
蛮	yoju
满	iagw
蔓	ajlc
曼	jlcu
慢	njlc
漫	ijlc
谩	yjlc
芒	aynb
茫	aiyn
盲	ynhf
氓	ynna
忙	nynn
莽	adaj
猫	qtal
茅	acnt
锚	qalg
毛	etgn
矛	cnht
铆	qqtb
卯	qtbh
茂	adu
冒	jhf
帽	mhjh
貌	erqn
贸	qyvm
么	tcu
玫	gty
枚	sty
梅	stxy
酶	sgtx
霉	ftxu
煤	ofsy
没	iwcy
眉	nhd
媒	vfsy
镁	qugd
每	txu
美	ugdu
昧	jfy
寐	pufu
妹	vfy
媚	vnhg
门	uyhn
闷	uni
们	wun
萌	ajef
蒙	apfe
檬	sape
盟	jelf
锰	qblg
猛	qtbl
梦	ssqu
孟	blf
眯	hoy
醚	sgop
靡	ossd
糜	osso
迷	opi
谜	yopy
弥	xqiy
米	oyty
秘	tntt
觅	emqb
泌	intt
蜜	pntj
密	pntm
幂	pjdh
棉	srmh
眠	hnan
绵	xrmh
冕	jqkq
免	qkqb
勉	qkqe
娩	vqkq
缅	xdlf
面	dljf
苗	alf
描	ralg
瞄	halg
藐	aerq
秒	titt
渺	ihit
庙	omd
妙	vitt
蔑	alaw
灭	goi
民	nav
抿	rnan
皿	lhng
敏	txty
悯	nuyy
闽	uji
明	jeg
螟	jpju
鸣	kqgg
铭	qqkg
名	qkf
命	wgkb
谬	ynwe
摸	rajd
摹	ajdr
蘑	aosd
模	sajd
膜	eajd
磨	ossd
摩	ossr
魔	ossc
抹	rgsy
末	gsi
莫	ajdu
墨	lfof
默	lfod
沫	igsy
漠	iajd
寞	pajd
陌	bdjg
谋	yfsy
牟	ctgj
某	fsu
拇	rxy
牡	cfg
亩	ylf
姆	vxy
母	xnny
墓	ajdf
暮	ajdj
幕	ajdh
募	ajde
慕	ajdn
木	ssss
目	hhhh
睦	hfwf
牧	cty
穆	trie
拿	wgkr
哪	kngb
呐	kmwy
钠	qmwy
那	ngbh
娜	vngb
纳	xmwy
氖	rbe
乃	bnt
奶	vbt
耐	dmjf
奈	dfiu
南	fmuf
男	ler
难	cwyg
囊	gkhe
挠	ratq
脑	eyrb
恼	nyrb
闹	uymh
淖	ihjh
呢	knxn
馁	qnev
内	mwi
嫩	vskt
能	cexx
妮	vnxn
霓	feqb
倪	weqn
泥	inxn
尼	nxv
拟	rnyw
你	wqiy
匿	aadk
腻	eafy
逆	ubtp
溺	ixuu
蔫	agho
拈	rhkg
年	tgj
碾	dnae
撵	rggl
捻	rwyn
念	wynn
娘	vyvy
酿	sgyv
鸟	qgd
尿	nii
捏	rjfg
聂	bccu
孽	atnb
啮	khwb
镊	qbcc
镍	qths
涅	ijfg
您	wqin
柠	spsh
狞	qtps
凝	uxth
宁	psj
拧	rpsh
泞	ipsh
牛	tgk
扭	rnhg
钮	qnhg
纽	xnhg
脓	epey
浓	ipey
农	pei
弄	gaj
奴	vcy
努	vcer
怒	vcnu
女	vvvv
暖	jegc
虐	hagd
疟	uagd
挪	rngb
懦	nfdj
糯	ofdj
诺	yadk
哦	ktry
欧	arqw
鸥	arqg
殴	arwc
藕	afsy
呕	kary
偶	wjmy
沤	iary
啪	krrg
趴	khwy
爬	rhyc
帕	mhrg
怕	nrg
琶	ggcb
拍	rrg
排	rhdd
牌	thgf
徘	thdd
湃	irdf
派	irey
攀	srrr
潘	itol
盘	tulf
磐	tuwd
盼	hwvt
畔	lugh
判	ugjh
叛	ugrc
乓	ryu
庞	odxy
旁	yupy
耪	fsyy
胖	eugh
抛	rvet
咆	kqnn
刨	qnjh
炮	oqnn
袍	puqn
跑	khqn
泡	iqnn
呸	kdhg
胚	edhg
培	fukg
裴	hdhe
赔	mukg
陪	bukg
配	sgnn
佩	wwgh
沛	igmh
喷	kfam
盆	wvlf
砰	dguf
抨	rguf
烹	ybou
澎	ifke
彭	fkue
蓬	atdp
棚	seeg
硼	deeg
篷	ttdp
膨	efke
朋	eeg
鹏	eeqg
捧	rdwg
碰	duog
坯	fdhg
砒	dxxn
霹	fnku
批	rxxn
披	rby
劈	nkuv
琵	ggxx
毗	lxxn
啤	krtf
脾	ertf
疲	ubi
皮	bnty
匹	aqv
痞	udhk
僻	wnku
屁	nxxv
譬	nkuy
篇	tyna
偏	wyna
片	thgn
骗	cgya
飘	sfir
漂	isfi
瓢	sfiy
票	sfiu
撇	rity
瞥	ithf
拼	ruah
频	hhdm
贫	wvmu
品	kkkf
聘	bmgn
乒	rtr
坪	fguf
苹	aguf
萍	aigf
平	gufk
凭	wtfw
瓶	uagy
评	yguf
屏	nuak
坡	fby
泼	inty
颇	bdmy
婆	ibvf
破	dby
魄	rrqc
迫	rpd
粕	org
剖	ukjh
扑	rhy
铺	qsy
仆	why
莆	asu
葡	aqsu
菩	aukf
蒲	aisu
埔	fsy
朴	shy
圃	lsi
普	uojf
浦	isy
谱	yuoj
曝	jjai
瀑	ijai
期	dweg
欺	dwqw
栖	ssg
戚	dhii
妻	gvhv
七	agn
凄	ugvv
漆	iswi
柒	iasu
沏	iavt
其	dwu
棋	sdwy
奇	dskf
歧	hfcy
畦	lffg
崎	mdsk
脐	eyjh
齐	yjj
旗	ytdw
祈	pyrh
祁	pybh
骑	cgdk
起	fhnv
岂	mnb
乞	tnb
企	whf
启	ynkd
契	dhvd
砌	davt
器	kkdk
气	rtgn
迄	tnpv
弃	ycaj
汽	irn
泣	iug
讫	ytnn
掐	rqeg
恰	nwgk
洽	iwgk
牵	dptg
扦	rtfh
钎	qtfh
铅	qwkg
千	tfk
迁	tfpk
签	twgg
仟	wtfh
谦	yuvw
乾	fjtn
黔	lfon
钱	qgay
钳	qfg
前	uejj
潜	iggj
遣	khgp
浅	igay
谴	ykhp
堑	lrff
嵌	mfqw
欠	qwu
歉	uvjw
枪	swbn
呛	kwbn
腔	epwa
羌	unv
墙	ffuk
蔷	afuk
强	xkjy
抢	rwbn
橇	seee
锹	qtoy
敲	ymkc
悄	nieg
桥	stdj
瞧	hwyo
乔	tdjj
侨	wtdj
巧	agnn
鞘	afie
撬	reee
翘	atgn
峭	mieg
俏	wieg
窍	pwan
切	avt
茄	aekf
且	egd
怯	nfcy
窃	pwav
钦	qqwy
侵	wvpc
亲	usu
秦	dwtu
琴	ggwn
勤	akge
芹	arj
擒	rwyc
禽	wyrc
寝	puvc
沁	iny
青	gef
轻	lcag
氢	rcad
倾	wxdm
卿	qtvb
清	igeg
擎	aqkr
晴	jgeg
氰	rged
情	ngeg
顷	xdmy
请	ygeg
庆	odi
琼	gyiy
穷	pwer
秋	toy
丘	rthg
邱	rbh
球	ggiy
求	giyi
囚	lwi
酋	usgf
泅	ilwy
趋	fhqv
区	ari
蛆	jegg
曲	mad
躯	tmdr
屈	nbmk
驱	cgar
渠	ians
取	bcy
娶	bcvf
龋	hwby
趣	fhbc
去	fcu
圈	lugb
颧	akkm
权	scy
醛	sgag
泉	riu
全	wgf
痊	uwgd
拳	ugrj
犬	dgty
券	ugvr
劝	cet
缺	tfbw
炔	onwy
瘸	uekw
却	fcbh
鹊	ajqg
榷	spwy
确	dqeh
雀	iwyf
裙	puvk
群	vtku
然	qdou
燃	oqdo
冉	mfd
染	ivsu
瓤	ykky
壤	fyke
攘	ryke
嚷	kyke
让	yhg
饶	qnaq
扰	rdny
绕	xatq
惹	adkn
热	rvyo
壬	tfd
仁	wfg
人	wwww
忍	vynu
韧	fnhy
任	wtfg
认	ywy
刃	vyi
妊	vtfg
纫	xvyy
扔	rbt
仍	wbt
日	jjjj
戎	ade
茸	abf
蓉	apwk
荣	apsu
融	gkmj
熔	opwk
溶	ipwk
容	pwwk
绒	xadt
冗	pwb
揉	rcns
柔	cnhs
肉	mwwi
茹	avkf
蠕	jfdj
儒	wfdj
孺	bfdj
如	vkg
辱	dfef
乳	ebnn
汝	ivg
入	tyi
褥	pudf
软	lqwy
阮	bfqn
蕊	annn
瑞	gmdj
锐	qukq
闰	ugd
润	iugg
若	adkf
弱	xuxu
撒	raet
洒	isg
萨	abut
腮	elny
鳃	qgln
塞	pawf
赛	pawm
三	dggg
叁	cddf
伞	wufj
散	aety
桑	cccs
嗓	kccs
丧	fueu
搔	rcyj
骚	cgcj
扫	rvg
嫂	vehc
瑟	ggnt
色	qcb
涩	ivyh
森	sssu
僧	wulj
莎	aiit
砂	ditt
杀	rsu
刹	rsjh
沙	iitt
纱	xitt
傻	wtlt
啥	kwfk
煞	qvto
筛	tjgh
晒	jsg
珊	gmmg
苫	ahkf
杉	set
山	mmmm
删	mmgj
煽	oynn
衫	puet
闪	uwi
陕	bgud
擅	rylg
赡	mqdy
膳	euuk
善	uukf
汕	imh
扇	ynnd
缮	xuuk
墒	fyuk
伤	wtet
商	yumk
赏	ipkm
晌	jtmk
上	hhgg
尚	imkf
裳	ipke
梢	sieg
捎	rieg
稍	tieg
烧	oatq
芍	aqyu
勺	qyi
韶	ujvk
少	ite
哨	kieg
邵	vkbh
绍	xvkg
奢	dftj
赊	mwfi
蛇	jpxn
舌	tdd
舍	wfkf
赦	foty
摄	rbcc
射	tmdf
慑	nbcc
涉	ihht
社	pyfg
设	ywcy
砷	djhh
申	jhk
呻	kjhh
伸	wjhh
身	tmdt
深	ipws
娠	vdfe
绅	xjhh
神	pyjh
沈	ipqn
审	pjhj
婶	vpjh
甚	dwnb
肾	jcef
慎	nfhw
渗	icde
声	fnr
生	tgd
甥	tgle
牲	ctgg
升	tak
绳	xkjn
省	ithf
盛	dnlf
剩	tuxj
胜	etgg
圣	cff
师	jgmh
失	tgi
狮	qtjh
施	ytbn
湿	ijog
诗	yffy
尸	nngt
虱	ntji
十	fgh
石	dgtg
拾	rwgk
时	jfy
什	wfh
食	wyvu
蚀	qnjy
实	pudu
识	ykwy
史	kri
矢	tdu
使	wgkr
屎	noi
驶	cgkr
始	vckg
式	aayi
示	fiu
士	fghg
世	anv
柿	symh
事	gkvh
拭	raay
誓	rryf
逝	rrpk
势	rvye
是	jghu
嗜	kftj
噬	ktaw
适	tdpd
仕	wfg
侍	wffy
释	tocg
饰	qnth
氏	qav
市	ymhj
恃	nffy
室	pgcf
视	pymq
试	yaay
收	nhty
手	rtgh
首	uthf
守	pfu
寿	dtfu
授	repc
售	wykf
受	epcu
瘦	uehc
兽	ulgk
蔬	anhk
枢	sary
梳	syck
殊	gqtf
抒	rcnh
输	lwgj
叔	hicy
舒	wfkh
淑	ihic
疏	nhyk
书	nnhy
赎	mfnd
孰	ybvy
熟	ybvo
薯	alfj
暑	jftj
曙	jlfj
署	lftj
蜀	lqju
黍	twiu
鼠	enun
属	ntky
术	syi
述	sypi
树	scfy
束	skd
戍	awi
竖	jcuf
墅	jfcf
庶	oaoi
数	ovty
漱	iskw
恕	vknu
刷	nmhj
耍	dmjv
摔	ryxf
衰	ykge
甩	env
帅	jmhh
栓	swgg
拴	rwgg
霜	fshf
双	ccy
爽	drrr
谁	ywyg
水	iiii
睡	htgf
税	tukq
吮	kcqn
瞬	hepg
顺	kdmy
舜	epqg
说	yukq
硕	ddmy
朔	ubte
烁	otni
斯	dwrh
撕	rdwr
嘶	kdwr
思	lnu
私	tcy
司	ngkd
丝	xxgf
死	gqxv
肆	dvgh
寺	ffu
嗣	kmak
四	lhng
伺	wngk
似	wnyw
饲	qnnk
巳	nngn
松	swcy
耸	wwbf
怂	wwnu
颂	wcdm
送	udpi
宋	psu
讼	ywcy
诵	yceh
搜	rehc
艘	tuec
擞	rovt
嗽	kskw
苏	aewu
酥	sgty
俗	wwwk
素	gxiu
速	skpd
粟	sou
僳	wsoy
塑	ubtf
溯	iube
宿	pwdj
诉	yryy
肃	vhjw
酸	sgct
蒜	afii
算	thaj
虽	kju
隋	bdae
随	bdep
绥	xevg
髓	medp
碎	dywf
岁	mqu
穗	tgjn
遂	uepi
隧	buep
祟	bmfi
孙	biy
损	rkmy
笋	tvtr
蓑	ayke
梭	scwt
唆	kcwt
缩	xpwj
琐	gimy
索	fpxi
锁	qimy
所	rnrh
塌	fjng
他	wbn
它	pxb
她	vbn
塔	fawk
獭	qtsm
挞	rdpy
蹋	khjn
踏	khij
胎	eckg
苔	ackf
抬	rckg
台	ckf
泰	dwiu
酞	sgdy
太	dyi
态	dynu
汰	idyy
坍	fmyg
摊	rcwy
贪	wynm
瘫	ucwy
滩	icwy
坛	ffcy
檀	sylg
痰	uooi
潭	isjh
谭	ysjh
谈	yooy
坦	fjgg
毯	eooi
袒	pujg
碳	dmdo
探	rpws
叹	kcy
炭	mdou
汤	inrt
塘	fovk
搪	rovk
堂	ipkf
棠	ipks
膛	eipf
唐	ovhk
糖	oovk
倘	wimk
躺	tmdk
淌	iimk
趟	fhik
烫	inro
掏	rqtb
涛	idtf
滔	ieeg
绦	xtsy
萄	aqtb
桃	sqiy
逃	qipi
淘	iqtb
陶	bqtb
讨	yfy
套	ddu
特	cffy
藤	aeui
腾	eugg
疼	utui
誊	ugyf
梯	suxt
剔	jqrj
踢	khjr
锑	quxt
提	rjgh
题	jghm
蹄	khyh
啼	kyuh
体	wsgg
替	ggjf
嚏	kfph
惕	njqr
涕	iuxt
剃	uxhj
屉	nanv
天	gdi
添	igdn
填	ffhw
田	llll
甜	tdfg
恬	ntdg
舔	tdgn
腆	emaw
挑	rqiy
条	tsu
迢	vkpd
眺	hqiy
跳	khqi
贴	mhkg
铁	qtgy
帖	mhhk
厅	dsk
听	krh
烃	ocag
汀	ish
廷	tfpd
停	wyps
亭	ypsj
庭	otfp
挺	rtfp
艇	tutp
通	cepk
桐	smgk
酮	sgmk
瞳	hujf
同	mgkd
铜	qmgk
彤	myet
童	ujff
桶	sceh
捅	rceh
筒	tmgk
统	xycq
痛	ucek
偷	wwgj
投	rwcy
头	udi
透	tbpe
凸	hghg
秃	twb
突	pwdu
图	ltui
徒	tfhy
途	wgsp
涂	iwgs
屠	nftj
土	ffff
吐	kfg
兔	qkqy
湍	imdj
团	lfte
推	rwyg
颓	twdm
腿	evpy
蜕	jukq
褪	puvp
退	vpi
吞	gdkf
屯	gbnv
臀	nawe
拖	rtbn
托	rtan
脱	eukq
鸵	qgpx
陀	bpxn
驮	cgdy
驼	cgpx
椭	sbde
妥	evf
拓	rdg
唾	ktgf
挖	rpwn
哇	kffg
蛙	jffg
洼	iffg
娃	vffg
瓦	gnny
袜	pugs
歪	dhgh
外	qhy
豌	gkub
弯	yoxb
湾	iyox
玩	gfqn
顽	fqdm
丸	vyi
烷	opfq
完	pfqb
碗	dpqb
挽	rqkq
晚	jqkq
皖	rpfq
惋	npqb
宛	pqbb
婉	vpqb
万	gqe
腕	epqb
汪	igg
王	gggg
亡	ynb
枉	sgg
网	mrri
往	tygg
旺	jgg
望	yneg
忘	ynnu
妄	ynvf
威	dgvd
巍	mtvc
微	tmgt
危	qdbb
韦	fnhk
违	fnhp
桅	sqdb
围	lfnh
唯	kwyg
惟	nwyg
为	yeyi
潍	ixwy
维	xwyg
苇	afnh
萎	atvf
委	tvf
伟	wfnh
伪	wyey
尾	nev
纬	xfnh
未	fggy
蔚	anff
味	kfy
畏	lgeu
胃	lef
喂	klge
魏	tvrc
位	wug
渭	ileg
谓	yleg
尉	nfif
慰	nfin
卫	bgd
瘟	ujld
温	ijlg
蚊	jyy
文	yygy
闻	ubd
纹	xyy
吻	kqrt
稳	tqvn
紊	yxiu
问	ukd
嗡	kwcn
翁	wcnf
瓮	wcgy
挝	rfpy
蜗	jkmw
涡	ikmw
窝	pwkw
我	trny
斡	fjwf
卧	ahnh
握	rngf
沃	itdy
巫	awwi
呜	ktng
钨	qtng
乌	tnng
污	ifnn
诬	yaww
屋	ngcf
无	fqv
芜	afqb
梧	sgkg
吾	gkf
吴	kgdu
毋	nnde
武	gahy
五	gghg
捂	rgkg
午	tfj
舞	tglg
伍	wgg
侮	wtxy
坞	ftng
戊	dgty
雾	fter
晤	jgkg
物	cqrt
勿	qre
务	ter
悟	ngkg
误	ykgd
昔	ajf
熙	ahko
析	srh
西	sghg
硒	dsg
矽	dqy
晰	jsrh
嘻	kfkk
吸	kbyy
锡	qjqr
牺	csg
稀	trdh
息	thnu
希	rdmh
悉	tonu
膝	eswi
夕	qtny
惜	najg
熄	othn
烯	ordh
溪	iexd
汐	iqy
犀	nitg
檄	sryt
袭	dxye
席	oamh
习	nud
媳	vthn
喜	fkuk
铣	qtfq
洗	itfq
系	txiu
隙	biji
戏	cay
细	xlg
瞎	hpdk
虾	jghy
匣	alk
霞	fnhc
辖	lpdk
暇	jnhc
峡	mgud
侠	wgud
狭	qtgd
下	ghi
厦	ddht
夏	dhtu
吓	kghy
掀	rrqw
锨	qrqw
先	tfqb
仙	wmh
鲜	qguh
纤	xtfh
咸	dgkd
贤	jcmu
衔	tqgs
舷	tuyx
闲	usi
涎	ithp
弦	xyxy
嫌	vuvw
显	jof
险	bwgg
现	gmqn
献	fmud
县	egcu
腺	eriy
馅	qnqe
羡	uguw
宪	ptfq
陷	bqeg
限	bvy
线	xgay
相	shg
厢	dshd
镶	qyke
香	tjf
箱	tshf
襄	ykke
湘	ishg
乡	xte
翔	ung
祥	pyuh
详	yuh
想	shnu
响	ktmk
享	ybf
项	admy
巷	awnb
橡	sqke
像	wqke
向	tmkd
象	qkeu
萧	avhw
硝	dieg
霄	fief
削	iejh
哮	kftb
嚣	kkdk
销	qieg
消	iieg
宵	pief
淆	irde
晓	jatq
小	ihty
孝	ftbf
校	sury
肖	ief
啸	kvhw
笑	ttdu
效	urty
楔	sdhd
些	hxff
歇	jqww
蝎	jjqn
鞋	afff
协	fewy
挟	rgud
携	rwyb
邪	ahtb
斜	wgsf
胁	eewy
谐	yxxr
写	pgng
械	saah
卸	tghb
蟹	qevj
懈	nqeg
泄	iann
泻	ipgg
谢	ytmf
屑	nied
薪	ausr
芯	anu
锌	quh
欣	rqwy
辛	uygh
新	usrh
忻	nrh
心	nyny
信	wyg
衅	tlug
星	jtgf
腥	ejtg
猩	qtjg
惺	njtg
兴	igwu
刑	gajh
型	gajf
形	gaet
邢	gabh
行	tgsh
醒	sgjg
幸	fufj
杏	skf
性	ntgg
姓	vtgg
兄	kqb
凶	rbk
胸	eqrb
匈	qrbk
汹	irbh
雄	dcwy
熊	cexo
休	wsy
修	whte
羞	unhg
朽	sgnn
嗅	kthd
锈	qtbt
秀	tbr
袖	pumg
绣	xtbt
墟	fhog
戌	dgd
需	fdmj
虚	hod
嘘	khog
须	edmy
徐	twgs
许	ytfh
蓄	ayxl
酗	sgrb
叙	wgsc
旭	vjd
序	ocnh
畜	yxlf
恤	ntlg
絮	vkxi
婿	vnhe
绪	xftj
续	xfnd
轩	lfh
喧	kpgg
宣	pgjg
悬	egcn
旋	ytnh
玄	yxu
选	tfqp
癣	uqgu
眩	hyxy
绚	xqjg
靴	afwx
薛	atnu
学	ipbf
穴	pwu
雪	fvf
血	tld
勋	kmet
熏	tglo
循	trfh
旬	qjd
询	yqjg
寻	vfu
驯	cgkh
巡	vpv
殉	gqqj
汛	infh
训	ykh
讯	ynfh
逊	bipi
迅	nfpk
压	dfyi
押	rlh
鸦	ahtg
鸭	lqgg
呀	kaht
丫	uhk
芽	aaht
牙	ahte
蚜	jaht
崖	mdff
衙	tgks
涯	idff
雅	ahty
哑	kgog
亚	god
讶	yaht
焉	ghgo
咽	kldy
阉	udjn
烟	oldy
淹	idjn
盐	fhlf
严	gote
研	dgah
蜒	jthp
岩	mdf
延	thnp
言	yyyy
颜	utem
阎	uqed
炎	oou
沿	iwkg
奄	djnb
掩	rdjn
眼	hvy
衍	tigs
演	ipgw
艳	dhqc
堰	fajv
燕	akuo
厌	ddi
砚	dmqn
雁	dwwy
唁	kyg
彦	utee
焰	oqeg
宴	pjvf
谚	yute
验	cgwg
殃	gqmd
央	mdi
鸯	mdqg
秧	tmdy
杨	snrt
扬	rnrt
佯	wuh
疡	unre
羊	uyth
洋	iuh
阳	bjg
氧	ruk
仰	wqbh
痒	uuk
养	ugjj
样	suh
漾	iugi
邀	rytp
腰	esvg
妖	vtdy
瑶	getb
摇	retb
尧	atgq
遥	etfp
窑	pwtb
谣	yetb
姚	vqiy
咬	kury
舀	eef
药	axqy
要	svf
耀	igqy
椰	sbbh
噎	kfpu
耶	bbh
爷	wrbj
野	jfch
冶	uckg
也	bnhn
页	dmu
掖	rywy
业	ohhg
叶	kfh
曳	jnte
腋	eywy
夜	ywty
液	iywy
一	ggll
壹	fpgu
医	atdi
揖	rkbg
铱	qyey
依	wyey
伊	wvtt
衣	yeu
颐	ahkm
夷	gxwi
遗	khgp
移	tqqy
仪	wyry
胰	egxw
疑	xtdh
沂	irh
宜	pegf
姨	vgxw
彝	xoxa
椅	sdsk
蚁	jyry
倚	wdsk
已	nnnn
乙	nnll
矣	ctdu
以	nywy
艺	anb
抑	rqbh
易	jqrr
邑	kcb
屹	mtnn
亿	wnn
役	twcy
臆	eujn
逸	qkqp
肄	xtdg
疫	uwci
亦	you
裔	yemk
意	ujnu
毅	uewc
忆	nnn
义	yri
益	uwlf
溢	iuwl
诣	yxjg
议	yyry
谊	ypeg
译	ycgh
异	naj
翼	nlaw
翌	nuf
绎	xcgh
茵	aldu
荫	abef
因	ldi
殷	rvnc
音	ujf
阴	beg
姻	vldy
吟	kwyn
银	qvy
淫	ietf
寅	pgmw
饮	qnqw
尹	vte
引	xhh
隐	bqvn
印	qgbh
英	amdu
樱	smmv
婴	mmvf
鹰	owwg
应	oigd
缨	xmmv
莹	apgy
萤	apju
营	apkk
荧	apou
蝇	jkjn
迎	qbpk
赢	yemy
盈	bclf
影	jyie
颖	xtdm
硬	dgjr
映	jmdy
哟	kxqy
拥	reh
佣	weh
臃	eyxy
痈	uek
庸	oveh
雍	yxty
踊	khce
蛹	jceh
咏	kyni
泳	iyni
涌	iceh
永	ynii
恿	cenu
勇	ceer
用	etnh
幽	mxxi
优	wdny
悠	whtn
忧	ndny
尤	dnyi
由	mhng
邮	mbh
铀	qmg
犹	qtdy
油	img
游	iytb
酉	sgd
有	def
友	dcu
右	dkf
佑	wdkg
釉	tomg
诱	ytbt
又	cccc
幼	xet
迂	gfpk
淤	iywu
于	gfk
盂	gflf
榆	swgj
虞	hkgd
愚	jmhn
舆	elgw
余	wgsu
俞	wgej
逾	wgep
鱼	qgf
愉	nwgj
渝	iwgj
渔	iqgg
隅	bjmy
予	cnhj
娱	vkgd
雨	fghy
与	gngd
屿	mgng
禹	tkmy
宇	pgfj
语	ygkg
羽	nnyg
玉	gyi
域	fakg
芋	agfj
郁	debh
吁	kgfh
遇	jmhp
喻	kwgj
峪	mwwk
御	ttgb
愈	wgen
欲	wwkw
狱	qtyd
育	ycef
誉	igwy
浴	iwwk
寓	pjmy
裕	puwk
预	cnhm
豫	cnhe
驭	cgcy
鸳	qbqg
渊	itoh
冤	pqky
元	fqb
垣	fgjg
袁	fkeu
原	drii
援	regc
辕	lfke
园	lfqv
员	kmu
圆	lkmi
猿	qtfe
源	idri
缘	xxey
远	fqpv
苑	aqbb
愿	drin
怨	qbnu
院	bpfq
曰	jhng
约	xqyy
越	fhan
跃	khtd
钥	qeg
岳	rmj
粤	tlon
月	eeee
悦	nukq
阅	uukq
耘	fsfc
云	fcu
郧	kmbh
匀	qud
陨	bkmy
允	cqb
运	fcpi
蕴	axjl
酝	sgfc
晕	jplj
韵	ujqu
孕	bbf
匝	amhk
砸	damh
杂	vsu
栽	fasi
哉	fakd
灾	pou
宰	puj
载	fald
再	gmfd
在	dhfd
咱	kthg
攒	rtfm
暂	lrjf
赞	tfqm
赃	mofg
脏	eofg
葬	agqa
遭	gmap
糟	ogmj
凿	oufb
藻	aiks
枣	smuu
早	jhnh
澡	ikks
蚤	cyju
躁	khks
噪	kkks
造	tfkp
皂	rab
灶	ofg
燥	okks
责	gmu
择	rcgh
则	mjh
泽	icgh
贼	madt
怎	thfn
增	fulj
憎	nulj
曾	uljf
赠	mulj
扎	rnn
喳	ksjg
渣	isjg
札	snn
轧	lnn
铡	qmjh
闸	ulk
眨	htpy
栅	smmg
榨	spwf
咋	kthf
乍	thff
炸	othf
诈	ythf
摘	ryud
斋	ydmj
宅	ptab
窄	pwtf
债	wgmy
寨	paws
瞻	hqdy
毡	ehkd
詹	qdwy
粘	ohkg
沾	ihkg
盏	galf
斩	lrh
辗	lnae
崭	mlrj
展	naei
蘸	asgo
栈	sgay
占	hkf
战	hkay
站	uhkg
湛	idwn
绽	xpgh
樟	sujh
章	ujj
彰	ujet
漳	iujh
张	xtay
掌	ipkr
涨	ixty
杖	sdyy
丈	dyi
帐	mhty
账	mtay
仗	wdyy
胀	etay
瘴	uujk
障	bujh
招	rvkg
昭	jvkg
找	ray
沼	ivkg
赵	fhri
照	jvko
罩	lhjj
兆	qii
肇	yntg
召	vkf
遮	oaop
折	rrh
哲	rrkf
蛰	rvyj
辙	lyct
者	ftjf
锗	qftj
蔗	aoao
这	ypi
浙	irrh
珍	gwet
斟	dwnf
真	fhwu
甄	sfgy
砧	dhkg
臻	gcft
贞	hmu
针	qfh
侦	whmy
枕	spqn
疹	uwee
诊	ywet
震	fdfe
振	rdfe
镇	qfhw
阵	blh
蒸	abio
挣	rqvh
睁	hqvh
征	tghg
狰	qtqh
争	qvhj
怔	nghg
整	skth
拯	rbig
正	ghd
政	ghty
帧	mhhm
症	ughd
郑	udbh
证	yghg
芝	apu
枝	sfcy
支	fcu
吱	kfcy
蜘	jtdk
知	tdkg
肢	efcy
脂	exjg
汁	ifh
之	pppp
织	xkwy
职	bkwy
直	fhf
植	sfhg
殖	gqfh
执	rvyy
值	wfhg
侄	wgcf
址	fhg
指	rxjg
止	hhgg
趾	khhg
只	kwu
旨	xjf
纸	xqan
志	fnu
挚	rvyr
掷	rudb
至	gcff
致	gcft
置	lfhf
帜	mhkw
峙	mffy
制	tgmj
智	tdkj
秩	ttgy
稚	twyg
质	rfmi
炙	qou
痔	uffi
滞	igkh
治	ickg
窒	pwgf
中	khk
盅	khlf
忠	khnu
钟	qkhh
衷	ykhe
终	xtuy
种	tkhh
肿	ekhh
重	tgjf
仲	wkhh
众	wwwu
舟	tui
周	mfkd
州	ytyh
洲	iyth
诌	yqvg
粥	xoxn
轴	lmg
肘	efy
帚	vpmh
咒	kkwb
皱	qvby
宙	pmf
昼	nyjg
骤	cgbi
珠	gtfy
株	stfy
蛛	jtfy
朱	tfi
猪	qtfj
诸	yftj
诛	ytfy
逐	gepi
竹	thth
烛	ojy
煮	ftjo
拄	rygg
瞩	hnty
嘱	knty
主	ygd
著	aftj
柱	sygg
助	eget
蛀	jygg
贮	mpgg
铸	qdtf
筑	tawy
住	wygg
注	iygg
祝	pykq
驻	cgyg
抓	rrhy
爪	rhyi
拽	rjnt
专	fnyi
砖	dfny
转	lfny
撰	rnnw
赚	muvw
篆	txeu
桩	sofg
庄	ofd
装	ufye
妆	uvg
撞	rujf
壮	ufg
状	udy
椎	swyg
锥	qwyg
追	tnpd
赘	gqtm
坠	bwff
缀	xccc
谆	yybg
准	uwyg
捉	rkhy
拙	rbmh
卓	hjj
桌	hjsu
琢	ggey
茁	abmj
酌	sgqy
啄	kgey
着	uhf
灼	oqyy
浊	ijy
兹	uxxu
咨	uqwk
资	uqwm
姿	uqwv
滋	iuxx
淄	ivlg
孜	bty
紫	hxxi
仔	wbg
籽	obg
滓	ipuh
子	bbbb
自	thd
渍	igmy
字	pbf
鬃	depi
棕	spfi
踪	khpi
宗	pfiu
综	xpfi
总	uknu
纵	xwwy
邹	qvbh
走	fhu
奏	dwgd
揍	rdwd
租	tegg
足	khu
卒	ywwf
族	yttd
祖	pyeg
诅	yegg
阻	begg
组	xegg
钻	qhkg
纂	thdi
嘴	khxe
醉	sgyf
最	jbcu
罪	lhdd
尊	usgf
遵	usgp
昨	jthf
左	daf
佐	wdag
柞	sthf
做	wdty
作	wthf
坐	wwfd
座	owwf
亍	gsj
丌	gjk
兀	gqv
丐	ghnv
廿	aghg
卅	gkk
丕	dhgd
亘	gjgf
丞	bigf
鬲	gkmh
孬	dhvb
噩	gkkk
丨	hhll
禺	jmhy
丿	ttll
匕	xtn
乇	tav
夭	tdi
爻	rru
卮	rgbv
氐	qayi
囟	tlri
胤	txen
馗	vuth
毓	txyk
睾	tlff
鼗	qifc
丶	yyll
亟	bkcg
鼐	bhnn
乜	nnv
乩	hknn
亓	fjj
芈	hghg
孛	fpbf
啬	fulk
嘏	dnhc
仄	dwi
厍	dlk
厝	dajd
厣	ddlk
厥	dubw
厮	ddwr
靥	dddf
赝	dwwm
匚	agn
叵	akd
匦	alvv
匮	akhm
匾	ayna
赜	ahkm
卦	ffhy
卣	hlnf
刂	jhh
刈	rjh
刎	qrjh
刭	cajh
刳	dfnj
刿	mqjh
剀	mnjh
剌	skjh
剞	dskj
剡	oojh
剜	pqbj
蒯	aeej
剽	sfij
劂	dubj
劁	wyoj
劐	awyj
劓	thlj
冂	mhn
罔	muyn
亻	wth
仃	wsh
仉	wwn
仂	wet
仨	wdg
仡	wtnn
仫	wtcy
仞	wvyy
伛	wary
仳	wxxn
伢	waht
佤	wgny
仵	wtfh
伥	wtay
伧	wwbn
伉	wywn
伫	wpgg
佞	wfvg
佧	whhy
攸	whty
佚	wtgy
佝	wqkg
佟	wtuy
佗	wpxn
伲	wnxn
伽	wekg
佶	wfkg
佴	wbg
侑	wdeg
侉	wdfn
侃	wkkn
侏	wtfy
佾	wweg
佻	wqiy
侪	wyjh
佼	wury
侬	wpey
侔	wctg
俦	wdtf
俨	wgot
俪	wgmy
俅	wgiy
俚	wjfg
俣	wkgd
俜	wmgn
俑	wceh
俟	wctd
俸	wdwg
倩	wgeg
偌	wadk
俳	whdd
倬	whjh
倏	whtd
倮	wjsy
倭	wtvg
俾	wrtf
倜	wmfk
倌	wpng
倥	wpwa
倨	wndg
偾	wfam
偃	wajv
偕	wxxr
偈	wjqn
偎	wlge
偬	wqrn
偻	wovg
傥	wipq
傧	wprw
傩	wcwy
傺	wwfi
僖	wfkk
儆	waqt
僭	waqj
僬	wwyo
僦	wyiy
僮	wujf
儇	wlge
儋	wqdy
仝	waf
氽	wiu
佘	wfiu
佥	wgig
俎	wweg
龠	wgka
汆	tyiu
籴	tyou
兮	wgnb
巽	nnaw
黉	ipaw
馘	uthg
冁	ujfe
夔	utht
勹	qtn
匍	qsi
訇	qyd
匐	qgkl
凫	qwb
夙	wgqi
兕	hnhq
亠	yyg
兖	ucqb
亳	ypta
衮	uceu
袤	ycne
亵	yrve
脔	yomw
裒	yeeu
禀	ylki
嬴	yevy
蠃	yejy
羸	yeuy
冫	uyg
冱	ugxg
冽	ugqj
冼	utfq
凇	uswc
冖	pyn
冢	pgey
冥	pjuu
讠	yyn
讦	yfh
讧	yag
讪	ymh
讴	yary
讵	yang
讷	ymwy
诂	ydg
诃	yskg
诋	yqay
诏	yvkg
诎	ybmh
诒	yckg
诓	yagg
诔	yfsy
诖	yffg
诘	yfkg
诙	ydoy
诜	ytfq
诟	yrgk
诠	ywgg
诤	yqvh
诨	yplh
诩	yng
诮	yieg
诰	ytfk
诳	yqtg
诶	yctd
诹	ybcy
诼	ygey
诿	ytvg
谀	yewy
谂	ywyn
谄	yqeg
谇	yywf
谌	ydwn
谏	yslg
谑	yhag
谒	yjqn
谔	ykkn
谕	ywgj
谖	yegc
谙	yujg
谛	yyuh
谘	yuqk
谝	yyna
谟	yajd
谠	yipq
谡	ylwt
谥	yuwl
谧	yntl
谪	yyud
谫	yuev
谮	yaqj
谯	ywyo
谲	ycnk
谳	yfmd
谵	yqdy
谶	ywwg
卩	bnh
卺	bigb
阝	bnh
阢	bgqn
阡	btfh
阱	bfjh
阪	brcy
阽	bhkg
阼	bthf
陂	bby
陉	bcag
陔	bynw
陟	bhht
陧	bjfg
陬	bbcy
陲	btgf
陴	brtf
隈	blge
隍	brgg
隗	brqc
隰	bjxo
邗	fbh
邛	abh
邝	obh
邙	ynbh
邬	tnnb
邡	ybh
邴	gmwb
邳	dhgb
邶	uxbh
邺	obh
邸	qayb
邰	ckbh
郏	gudb
郅	gcfb
邾	tfbh
郐	wfcb
郄	rdcb
郇	qjbh
郓	plbh
郦	gmyb
郢	kgbh
郜	tfkb
郗	rdmb
郛	ebbh
郫	rtfb
郯	oobh
郾	ajvb
鄄	sfbh
鄢	ghgb
鄞	akgb
鄣	ujbh
鄱	tolb
鄯	uukb
鄹	bcib
酃	fkkb
酆	mdhb
刍	qvf
奂	qmdu
劢	gqet
劬	qket
劭	vket
劾	ynte
哿	eksk
勐	blet
勖	jhet
勰	eeen
叟	ehcu
燮	yooc
矍	hhwc
廴	pny
凵	bnh
凼	ibk
鬯	obxb
厶	cny
弁	caj
畚	cdlf
巯	cayk
坌	wvff
垩	goff
垡	waff
塾	ybvf
墼	lbwf
壅	yxtf
壑	hpgf
圩	fgfh
圬	ffnn
圪	ftnn
圳	fkh
圹	fot
圮	fnn
圯	fnn
坜	fdet
圻	frh
坂	frcy
坩	ffg
垅	fdxy
坫	fhkg
垆	fhnt
坼	fryy
坻	fqay
坨	fpxn
坭	fnxn
坶	fxy
坳	fxet
垭	fgog
垤	fgcf
垌	fmgk
垲	fmnn
埏	fthp
垧	ftmk
垴	fyrb
垓	fynw
垠	fvy
埕	fkgg
埘	fjfy
埚	fkmw
埙	fkmy
埒	fefy
垸	fpfq
埴	ffhg
埯	fdjn
埸	fjqr
埤	frtf
埝	fwyn
堋	feeg
堍	fqky
埽	fvph
埭	fviy
堀	fnbm
堞	fans
堙	fsfg
塄	flyt
堠	fwnd
塥	fgkh
塬	fdri
墁	fjlc
墉	fovh
墚	fivs
墀	fnig
馨	fnwj
鼙	fkuf
懿	fpgn
艹	aghh
艽	avb
艿	abr
芏	aff
芊	atfj
芨	abyu
芄	avyu
芎	axb
芑	anb
芗	axtr
芙	agu
芫	afqb
芸	afcu
芾	agmh
芰	afcu
苈	ader
苊	adbb
苣	aanf
芘	axxb
芷	ahf
芮	amwu
苋	amqb
苌	atay
苁	awwu
芩	awyn
芴	aqrr
芡	aqwu
芪	aqab
芟	awcu
苄	ayhu
苎	apgf
芤	abnb
苡	anyw
茉	agsu
苷	aff
苤	adhg
茏	adxy
茇	adcy
苜	ahf
苴	aegf
苒	amff
苘	amkf
茌	awff
苻	awfu
苓	awyc
茑	aqgf
茚	aqgb
茆	aqtb
茔	apff
茕	apnf
苠	anab
苕	avkf
茜	asf
荑	agxw
荛	aatq
荜	axxf
茈	ahxb
莒	akkf
茼	amgk
茴	alkf
茱	atfu
莛	atfp
荞	atdj
茯	awdu
荏	awtf
荇	atgs
荃	awgf
荟	awfc
荀	aqjf
茗	aqkf
荠	ayjj
茭	auru
茺	aycq
茳	aiaf
荦	aptg
荥	apiu
荨	avfu
茛	avu
荩	anyu
荬	anud
荪	abiu
荭	axaf
荮	axfu
莰	afqw
荸	afpb
莳	ajfu
莴	akmw
莠	atbr
莪	atry
莓	atxu
莜	awht
莅	awuf
荼	awgs
莶	awgg
莩	aebf
荽	aevf
莸	aqty
荻	aqto
莘	auj
莞	apfq
莨	ayvu
莺	apqg
莼	axgn
菁	agef
萁	adwu
菥	asrj
菘	aswc
堇	akgf
萘	adfi
萋	agvv
菝	ardy
菽	ahic
菖	ajjf
萜	amhk
萸	aewu
萑	awyf
萆	artf
菔	aebc
菟	aqky
萏	aqef
萃	aywf
菸	aywu
菹	aieg
菪	apdf
菅	apnf
菀	apqb
萦	apxi
菰	abry
菡	abib
葜	adhd
葑	afff
葚	adwn
葙	ashf
葳	adgv
蒇	admu
蒈	axxr
葺	akbf
蒉	akhm
葸	alnu
萼	akkn
葆	awks
葩	arcb
葶	ayps
蒌	aovf
蒎	aire
萱	apgg
葭	anhc
蓁	adwt
蓍	aftj
蓐	adff
蓦	ajdg
蒽	aldn
蓓	awuk
蓊	awcn
蒿	aymk
蒺	autd
蓠	ayrc
蒡	ayuy
蒹	auvw
蒴	aube
蒗	aiyv
蓥	apqf
蓣	acnm
蔌	askw
甍	alpy
蔸	arqq
蓰	athh
蔹	awgt
蔟	aytd
蔺	auwy
蕖	aias
蔻	apfc
蓿	apwj
蓼	anwe
蕙	agjn
蕈	asjj
蕨	aduw
蕤	ageg
蕞	ajbc
蕺	akby
瞢	alph
蕃	atol
蕲	aujr
蕻	adaw
薤	agqg
薨	alpx
薇	atmt
薏	aujn
蕹	ayxy
薮	aovt
薜	anku
薅	avdf
薹	afkf
薷	afdj
薰	atgo
藓	aqgu
藁	ayms
藜	atqi
藿	afwy
蘧	ahgp
蘅	atqs
蘩	atxi
蘖	atns
蘼	aosd
廾	agth
弈	yoaj
夼	dkj
奁	daru
耷	dbf
奕	yodu
奚	exdu
奘	ufdu
匏	dfnn
尢	dnv
尥	dnqy
尬	dnwj
尴	dnjl
扌	rghg
扪	run
抟	rfny
抻	rjhh
拊	rwfy
拚	rcah
拗	rxet
拮	rfkg
挢	rtdj
拶	rvqy
挹	rkcn
捋	refy
捃	rvtk
掭	rgdn
揶	rbbh
捱	rdff
捺	rdfi
掎	rdsk
掴	rlgy
捭	rrtf
掬	rqoy
掊	rukg
捩	rynd
掮	ryne
掼	rxmy
揲	rans
揸	rsjg
揠	rajv
揿	rqqw
揄	rwgj
揞	rujg
揎	rpgg
摒	rnua
揆	rwgd
掾	rxey
摅	rhny
摁	rldn
搋	rrhw
搛	ruvw
搠	rube
搌	rnae
搦	rxuu
搡	rccs
摞	rlxi
撄	rmmv
摭	roao
撖	rnbt
摺	rnrg
撷	rfkm
撸	rqgj
撙	rusf
撺	rpwh
擀	rfjf
擐	rlge
擗	rnku
擤	rthj
擢	rnwy
攉	rfwy
攥	rthi
攮	rgke
弋	ayi
忒	anyi
甙	afyi
弑	rsay
卟	khy
叱	kxn
叽	kwn
叩	kbh
叨	kvt
叻	ket
吒	ktan
吖	kuhh
吆	kxy
呋	kgy
呒	kfqn
呓	kann
呔	kdyy
呖	kdet
呃	kdbn
吡	kxxn
呗	kmy
呙	kmwu
吣	kny
吲	kxhh
咂	kamh
咔	khhy
呷	klh
呱	krcy
呤	kwyc
咚	ktuy
咛	kpsh
咄	kbmh
呶	kvcy
呦	kxet
咝	kxxg
哐	kagg
咭	kfkg
哂	ksg
咴	kdoy
哒	kdpy
咧	kgqj
咦	kgxw
哓	katq
哔	kxxf
呲	khxn
咣	kigq
哕	kmqy
咻	kwsy
咿	kwvt
哌	krey
哙	kwfc
哚	kwsy
哜	kyjh
咩	kuh
咪	koy
咤	kpta
哝	kpey
哏	kvy
哞	kctg
唛	kgty
哧	kfoy
唠	kape
哽	kgjr
唔	kgkg
哳	krrh
唢	kimy
唣	kran
唏	krdh
唑	kwwf
唧	kvbh
唪	kdwg
啧	kgmy
喏	kadk
喵	kalg
啉	kssy
啭	klfy
啁	kmfk
啕	kqtb
唿	kqrn
啐	kywf
唼	kuvg
唷	kyce
啖	kooy
啵	kiby
啶	kpgh
啷	kyvb
唳	kynd
唰	knmj
啜	kccc
喋	kans
嗒	kawk
喃	kfmf
喱	kdjf
喹	kdff
喈	kxxr
喁	kjmy
喟	kleg
啾	ktoy
嗖	kehc
喑	kujg
啻	yupk
嗟	kuag
喽	kovg
喾	iptk
喔	kngf
喙	kxey
嗪	kdwt
嗷	kgqt
嗉	kgxi
嘟	kftb
嗑	kfcl
嗫	kbcc
嗬	kawk
嗔	kfhw
嗦	kfpi
嗝	kgkh
嗄	kdht
嗯	kldn
嗥	krdf
嗲	kwrq
嗳	kepc
嗌	kuwl
嗍	kube
嗨	kitx
嗵	kcep
嗤	kbhj
辔	xlxk
嘞	kafe
嘈	kgmj
嘌	ksfi
嘁	kdhi
嘤	kmmv
嘣	kmee
嗾	kytd
嘀	kyud
嘧	kpnm
嘭	kfke
噘	kduw
嘹	kdui
噗	koug
嘬	kjbc
噍	kwyo
噢	ktmd
噙	kwyc
噜	kqgj
噌	kulj
噔	kwgu
嚆	kayk
噤	kssi
噱	khge
噫	kujn
噻	kpaf
噼	knku
嚅	kfdj
嚓	kpwi
嚯	kfwy
囔	kgke
囗	lhng
囝	lbd
囡	lvd
囵	lwxv
囫	lqre
囹	lwyc
囿	lded
圄	lgkd
圊	lged
圉	lfuf
圜	llge
帏	mhfh
帙	mhtg
帔	mhby
帑	vcmh
帱	mhdf
帻	mhgm
帼	mhly
帷	mhwy
幄	mhnf
幔	mhjc
幛	mhuj
幞	mhog
幡	mhtl
岌	mbyu
屺	mnn
岍	mgah
岐	mfcy
岖	mary
岈	maht
岘	mmqn
岙	tdmj
岑	mwyn
岚	mwru
岜	mcb
岵	mdg
岢	mskf
岽	maiu
岬	mlh
岫	mmg
岱	waym
岣	mqkg
峁	mqtb
岷	mnan
峄	mcgh
峒	mmgk
峤	mtdj
峋	mqjg
峥	mqvh
崂	mape
崃	mgus
崧	mswc
崦	mdjn
崮	mldf
崤	mrde
崞	mybg
崆	mpwa
崛	mnbm
嵘	maps
崾	msvg
崴	mdgv
崽	mlnu
嵬	mrqc
嵛	mwgj
嵯	muag
嵝	movg
嵫	muxx
嵋	mnhg
嵊	mtux
嵩	mymk
嵴	miwe
嶂	mujh
嶙	moqg
嶝	mwgu
豳	mgee
嶷	mxth
巅	mfhm
彳	ttth
彷	tyt
徂	tegg
徇	tqjg
徉	tuh
後	txty
徕	tgus
徙	thhy
徜	timk
徨	trgg
徭	tetb
徵	tmgt
徼	tryt
衢	thhs
彡	ettt
犭	qttt
犰	qtvn
犴	qtfh
犷	qtot
犸	qtcg
狃	qtng
狁	qtcq
狎	qtlh
狍	qtqn
狒	qtxj
狨	qtad
狯	qtwc
狩	qtpf
狲	qtbi
狴	qtxf
狷	qtke
猁	qttj
狳	qtws
猃	qtwg
狺	qtyg
狻	qtct
猗	qtdk
猓	qtjs
猡	qtlq
猊	qteq
猞	qtwk
猝	qtyf
猕	qtxi
猢	qtde
猹	qtsg
猥	qtle
猬	qtle
猸	qtnh
猱	qtcs
獐	qtuj
獍	qtuq
獗	qtdw
獠	qtdi
獬	qtqg
獯	qtto
獾	qtay
舛	qgh
夥	jsqq
飧	qwyv
夤	qpgw
夂	ttny
饣	qnb
饧	qnnr
饨	qngn
饩	qnrn
饪	qntf
饫	qntd
饬	qnte
饴	qnck
饷	qntk
饽	qnfb
馀	qnws
馄	qnjx
馇	qnsg
馊	qnec
馍	qnad
馐	qnug
馑	qnag
馓	qnat
馔	qnnw
馕	qnge
庀	oxv
庑	ofqv
庋	ofci
庖	oqnv
庥	owsi
庠	ouk
庹	oany
庵	odjn
庾	oewi
庳	ortf
赓	ovwm
廒	ogqt
廑	oakg
廛	ojff
廨	oqeg
廪	oyli
膺	owwe
忄	nyhy
忉	nvt
忖	nfy
忏	ntfh
怃	nfqn
忮	nfcy
怄	nary
忡	nkhh
忤	ntfh
忾	nrn
怅	ntay
怆	nwbn
忪	nwcy
忭	nyhy
忸	nnhg
怙	ndg
怵	nsyy
怦	nguf
怛	njgg
怏	nmdy
怍	nthf
怩	nnxn
怫	nxjh
怊	nvkg
怿	ncgh
怡	nckg
恸	nfce
恹	nddy
恻	nmjh
恺	nmnn
恂	nqjg
恪	ntkg
恽	nplh
悖	nfpb
悚	nskg
悭	njcf
悝	njfg
悃	nlsy
悒	nkcn
悌	nuxt
悛	ncwt
惬	nagd
悻	nfuf
悱	nhdd
惝	nimk
惘	nmun
惆	nmfk
惚	nqrn
悴	nywf
愠	njlg
愦	nkhm
愕	nkkn
愣	nlyt
惴	nmdj
愀	ntoy
愎	ntjt
愫	ngxi
慊	nuvw
慵	novh
憬	njyi
憔	nwyo
憧	nujf
憷	nssh
懔	nyli
懵	nalh
忝	gdnu
隳	bdan
闩	ugd
闫	udd
闱	ufnh
闳	udci
闵	uyi
闶	uywv
闼	udpi
闾	ukkd
阃	ulsi
阄	uqjn
阆	uyvi
阈	uakg
阊	ujjd
阋	ueqv
阌	uepc
阍	uqaj
阏	uywu
阒	uhdi
阕	uwgd
阖	ufcl
阗	ufhw
阙	uubw
阚	unbt
丬	uygh
爿	unht
戕	uay
氵	iyyg
汔	itnn
汜	inn
汊	icyy
沣	idhh
沅	ifqn
沐	isy
沔	ighn
沌	igbn
汨	ijg
汩	ijg
汴	iyhy
汶	iyy
沆	iywn
沩	iyey
泐	ibet
泔	ifg
沭	isyy
泷	idxy
泸	ihnt
泱	imdy
泗	ilg
沲	itbn
泠	iwyc
泖	iqtb
泺	itni
泫	iyxy
泮	iugh
沱	ipxn
泓	ixcy
泯	inan
泾	icag
洹	igjg
洧	ideg
洌	igqj
浃	igud
浈	ihmy
洇	ildy
洄	ilkg
洙	itfy
洎	ithg
洫	itlg
浍	iwfc
洮	iqiy
洵	iqjg
洚	itgh
浏	iyjh
浒	iytf
浔	ivfy
洳	ivkg
涑	iskg
浯	igkg
涞	igus
涠	ilfh
浞	ikhy
涓	ikeg
涔	imwn
浜	irwy
浠	irdh
浼	iqkq
浣	ipfq
渚	iftj
淇	idwy
淅	isrh
淞	iswc
渎	ifnd
涿	igey
淠	ilgj
渑	ikjn
淦	iqg
淝	iecn
淙	ipfi
渖	ipjh
涫	ipng
渌	iviy
涮	inmj
渫	ians
湮	isfg
湎	idlf
湫	itoy
溲	iehc
湟	irgg
溆	iwgc
湓	iwvl
湔	iuej
渲	ipgg
渥	ingf
湄	inhg
滟	idhc
溱	idwt
溘	ifcl
滠	ibcc
漭	iada
滢	iapy
溥	isfy
溧	issy
溽	idff
溻	ijng
溷	ilge
滗	iten
溴	ithd
滏	iwru
溏	iovk
滂	iyuy
溟	ipju
潢	iamw
潆	iapi
潇	iavw
漤	issv
漕	igmj
滹	ihtf
漯	ilxi
漶	ikkn
潋	iwgt
潴	iqtj
漪	iqtk
漉	ioxx
漩	iyth
澉	inbt
澍	ifkf
澌	idwr
潸	isse
潲	itie
潼	iujf
潺	inbb
濑	iskm
濉	ihwy
澧	imau
澹	iqdy
澶	iylg
濂	iouw
濡	ifdj
濮	iwog
濞	ithj
濠	iype
濯	inwy
瀚	ifjn
瀣	ihqg
瀛	iyey
瀹	iwga
瀵	iolw
灏	ijym
灞	ifae
宀	pyyn
宄	pvb
宕	pdf
宓	pntr
宥	pdef
宸	pdfe
甯	pnej
骞	pawg
搴	pawr
寤	pugk
寮	pdui
褰	pawe
寰	plge
蹇	pawh
謇	pawy
辶	pyny
迓	ahtp
迕	tfpk
迥	mkpd
迮	thfp
迤	tbpv
迩	qipi
迦	ekpd
迳	capd
迨	ckpd
逅	rgkp
逄	tgpk
逋	spi
逦	gmyp
逑	giyp
逍	iepd
逖	qtop
逡	cwtp
逵	fwfp
逶	tvpd
逭	pnpd
逯	vipi
遄	mdmp
遑	rgpd
遒	usgp
遐	nhfp
遨	gqtp
遘	amfp
遢	jnpd
遛	qyvp
暹	jwyp
遴	oqgp
遽	hgep
邂	qevp
邈	erqp
邃	pwup
邋	vlrp
彐	vngg
彗	dhdv
彖	xeu
彘	xxtx
尻	nvv
咫	nykw
屐	ntfc
屙	nbsk
孱	nbbb
屣	nthh
屦	ntov
羼	nuuu
弪	xcag
弩	vcxb
弭	xbg
艴	xjqc
弼	xdjx
鬻	xoxh
屮	bhk
妁	vqyy
妃	vnn
妍	vgah
妩	vfqn
妪	vary
妣	vxxn
妗	vwyn
姊	vtnt
妫	vyey
妞	vnhg
妤	vcnh
姒	vnyw
妲	vjgg
妯	vmg
姗	vmmg
妾	uvf
娅	vgog
娆	vatq
姝	vtfy
娈	yovf
姣	vury
姘	vuah
姹	vpta
娌	vjfg
娉	vmgn
娲	vkmw
娴	vusy
娑	iitv
娣	vuxt
娓	vnen
婀	vbsk
婧	vgeg
婊	vgey
婕	vgvh
娼	vjjg
婢	vrtf
婵	vujf
胬	vcmw
媪	vjlg
媛	vegc
婷	vyps
婺	cnhv
媾	vamf
嫫	vajd
媲	vtlx
嫒	vepc
嫔	vprw
媸	vbhj
嫠	ftdv
嫣	vgho
嫱	vfuk
嫖	vsfi
嫦	viph
嫘	vlxi
嫜	vujh
嬉	vfkk
嬗	vylg
嬖	nkuv
嬲	leve
嬷	vosc
孀	vfsh
尕	biu
尜	idiu
孚	ebf
孥	vcbf
孳	uxxb
孑	bnhg
孓	byi
孢	bqnn
驵	cgeg
驷	cglg
驸	cgwf
驺	cgqv
驿	cgcg
驽	vccg
骀	cgck
骁	cgaq
骅	cgwf
骈	cgua
骊	cggy
骐	cgdw
骒	cgjs
骓	cgwy
骖	cgce
骘	bhhg
骛	cnhg
骜	gqtg
骝	cgql
骟	cgyn
骠	cgsi
骢	cgtn
骣	cgnb
骥	cguw
骧	cgye
纟	xnng
纡	xgfh
纣	xfy
纥	xtnn
纨	xvyy
纩	xot
纭	xfcy
纰	xxxn
纾	xcnh
绀	xfg
绁	xann
绂	xdcy
绉	xqvg
绋	xxjh
绌	xbmh
绐	xckg
绔	xdfn
绗	xtgs
绛	xtgh
绠	xgjr
绡	xieg
绨	xuxt
绫	xfwt
绮	xdsk
绯	xhdd
绱	ximk
绲	xjxx
缍	xtgf
绶	xepc
绺	xthk
绻	xugb
绾	xpng
缁	xvlg
缂	xafh
缃	xshg
缇	xjgh
缈	xhit
缋	xkhm
缌	xlny
缏	xwgr
缑	xwnd
缒	xtnp
缗	xnaj
缙	xgoj
缜	xfhw
缛	xdff
缟	xymk
缡	xyrc
缢	xuwl
缣	xuvw
缤	xprw
缥	xsfi
缦	xjlc
缧	xlxi
缪	xnwe
缫	xvjs
缬	xfkm
缭	xdui
缯	xulj
缰	xglg
缱	xkhp
缲	xkks
缳	xlge
缵	xtfm
幺	xxxx
畿	xxal
巛	vnnn
甾	vlf
邕	vkcb
玎	gsh
玑	gwn
玮	gfnh
玢	gwvt
玟	gyy
珏	ggyy
珂	gskg
珑	gdxy
玷	ghkg
玳	gway
珀	grg
珉	gnan
珈	gekg
珥	gbg
珙	gawy
顼	gdmy
琊	gahb
珩	gtgs
珧	gqiy
珞	gtkg
玺	qigy
珲	gplh
琏	glpy
琪	gdwy
瑛	gamd
琦	gdsk
琥	ghwn
琨	gjxx
琰	gooy
琮	gpfi
琬	gpqb
琛	gpws
琚	gndg
瑁	gjhg
瑜	gwgj
瑗	gegc
瑕	gnhc
瑙	gvtr
瑷	gepc
瑭	govk
瑾	gakg
璜	gamw
璎	gmmv
璀	gmwy
璁	gtln
璇	gyth
璋	gujh
璞	goug
璨	ghqo
璩	ghge
璐	gkhk
璧	nkuy
瓒	gtfm
璺	emgy
韪	jghh
韫	fnhl
韬	fnhe
杌	sgqn
杓	sqyy
杞	snn
杈	scyy
杩	scgg
枥	sdet
枇	sxxn
杪	sitt
杳	sjf
枘	smwy
枧	smqn
杵	stfh
枨	stay
枞	swwy
枭	qsu
枋	syt
杷	scn
杼	scnh
柰	sfiu
栉	sabh
柘	sdg
栊	sdxy
柩	saqy
枰	sguf
栌	shnt
柙	slh
枵	skgn
柚	smg
枳	skwy
柝	sryy
栀	srgb
柃	swyc
枸	sqkg
柢	sqay
栎	stni
柁	spxn
柽	scfg
栲	sftn
栳	sftx
桠	sgog
桡	satq
桎	sgcf
桢	shmy
桄	sigq
桤	smnn
梃	stfp
栝	stdg
桕	seg
桦	swxf
桁	stgs
桧	swfc
桀	qgsu
栾	yosu
桊	ugsu
桉	spvg
栩	sng
梵	sswy
梏	stfk
桴	sebg
桷	sqeh
梓	suh
桫	siit
棂	svoy
楮	sftj
棼	sswv
椟	sfnd
椠	lrsu
棹	shjh
椤	slqy
棰	stgf
椋	syiy
椁	sybg
楗	svgp
棣	sviy
椐	sndg
楱	sdwd
椹	sdwn
楠	sfmf
楂	ssjg
楝	sslg
榄	sjtq
楫	skbg
榀	skkk
榘	tdas
楸	stoy
椴	sthc
槌	stnp
榇	susy
榈	sukk
槎	suag
榉	sigg
楦	spgg
楣	snhg
楹	sbcl
榛	sdwt
榧	sahd
榻	sjng
榫	swyf
榭	stmf
槔	srdf
榱	syke
槁	symk
槊	ubts
槟	sprw
榕	spwk
槠	syfj
榍	snie
槿	sakg
樯	sfuk
槭	sdhi
樗	sffn
樘	sipf
橥	qtfs
槲	sqef
橄	snbt
樾	sfhn
檠	aqks
橐	gkhs
橛	sduw
樵	swyo
檎	swyc
橹	sqgj
樽	susf
樨	snig
橘	scnk
橼	sxxe
檑	sflg
檐	sqdy
檩	syli
檗	nkus
檫	spwi
猷	usgd
獒	gqtd
殁	gqwc
殂	gqeg
殇	gqtr
殄	gqwe
殒	gqkm
殓	gqwg
殍	gqeb
殚	gquf
殛	gqbg
殡	gqpw
殪	gqfu
轫	lvyy
轭	ldbn
轱	ldg
轲	lskg
轳	lhnt
轵	lkwy
轶	ltgy
轸	lwet
轷	ltuf
轹	ltni
轺	lvkg
轼	laay
轾	lgcf
辁	lwgg
辂	ltkg
辄	lbnn
辇	gglj
辋	lmun
辍	lccc
辎	lvlg
辏	ldwd
辘	loxx
辚	loqg
軎	lkf
戋	gai
戗	wbay
戛	dhau
戟	fjay
戢	kbny
戡	dwna
戥	jtga
戤	bcla
戬	goja
臧	auah
瓯	argy
瓴	wycy
瓿	ukgy
甏	fkuy
甑	uljy
甓	nkuy
攴	hcu
旮	vjf
旯	jvb
旰	jfh
昊	jgdu
昙	jfcu
杲	jsu
昃	jdwu
昕	jrh
昀	jqug
炅	jou
曷	jqwn
昝	thjf
昴	jqtb
昱	juf
昶	ynij
昵	jnxn
耆	ftxj
晟	jdnb
晔	jwxf
晁	jqiu
晏	jpvf
晖	jplh
晡	jsy
晗	jwyk
晷	jthk
暄	jpgg
暌	jwgd
暧	jepc
暝	jpju
暾	jybt
曛	jtgo
曜	jnwy
曦	jugy
曩	jyke
贲	famu
贳	anmu
贶	mkqn
贻	mckg
贽	rvym
赀	hxmu
赅	mynw
赆	mnyu
赈	mdfe
赉	gusm
赇	mgiy
赍	fwwm
赕	mooy
赙	msfy
觇	hkmq
觊	mnmq
觋	awwq
觌	fnuq
觎	wgeq
觏	amfq
觐	akgq
觑	homq
牮	wayg
犟	xkjg
牝	cxn
牦	cen
牯	cdg
牾	cgkg
牿	ctfk
犄	cdsk
犋	chwy
犍	cvgp
犏	cyna
犒	cymk
挈	dhvr
挲	iitr
掰	rwvr
搿	rwgr
擘	nkur
耄	ftxe
毪	ectg
毳	eeeb
毽	evgp
毵	cdee
毹	wgee
氅	imke
氇	eqgj
氆	euoj
氍	hhwe
氕	rte
氘	rjk
氙	rmk
氚	rkk
氡	rtui
氩	rgod
氤	rldi
氪	rdqv
氲	rjld
攵	ttgy
敕	skty
敫	ryty
牍	thgd
牒	thgs
牖	thgs
爰	egdc
虢	efhw
刖	ejh
肟	efnn
肜	eet
肓	ynef
肼	efjh
朊	efqn
肽	edyy
肱	edcy
肫	egbn
肭	emwy
肴	rdef
肷	eqwy
胧	edxy
胨	eaiy
胩	ehhy
胪	ehnt
胛	elh
胂	ejhh
胄	mef
胙	ethf
胍	ercy
胗	ewet
朐	eqkg
胝	eqay
胫	ecag
胱	eigq
胴	emgk
胭	eldy
脍	ewfc
脎	ersy
胲	eynw
胼	euah
朕	eudy
脒	eoy
豚	egey
脶	ekmw
脞	ewwf
脬	eebg
脘	epfq
脲	eniy
腈	egeg
腌	edjn
腓	ehdd
腴	eewy
腙	epfi
腚	epgh
腱	evgp
腠	edwd
腩	efmf
腼	edlf
腽	ejlg
腭	ekkn
腧	ewgj
塍	eugf
媵	eugv
膈	egkh
膂	ytee
膑	eprw
滕	eugi
膣	epwf
膪	eyuk
臌	efkc
朦	eape
臊	ekks
膻	eylg
臁	eouw
膦	eoqg
欤	gngw
欷	rdmw
欹	dskw
歃	tfew
歆	ujqw
歙	wgkw
飑	wrqn
飒	uwry
飓	wrhw
飕	wrec
飙	dddr
飚	wroo
殳	wcu
彀	fpgc
毂	fplc
觳	fpgc
斐	hdhy
齑	yjhg
斓	yusl
於	ywuy
旆	ytgh
旄	yten
旃	ytmy
旌	yttg
旎	ytnx
旒	ytyk
旖	ytdk
炀	onrt
炜	ofnh
炖	ogbn
炝	owbn
炻	odg
烀	otuf
炷	oygg
炫	oyxy
炱	ckou
烨	owxf
烊	ouh
焐	ogkg
焓	owyk
焖	ouny
焯	ohjh
焱	ooou
煳	odeg
煜	ojug
煨	olge
煅	othc
煲	wkso
煊	opgg
煸	oyna
煺	ovpy
熘	oqyl
熳	ojlc
熵	oyuk
熨	nfio
熠	onrg
燠	otmd
燔	otol
燧	ouep
燹	gego
爝	oelf
爨	emgo
灬	oyyy
焘	dtfo
煦	jqko
熹	fkuo
戾	yndi
戽	ynuf
扃	ynmk
扈	ynkc
扉	ynhd
礻	pyyy
祀	pynn
祆	pygd
祉	pyhg
祛	pyfc
祜	pydg
祓	pydy
祚	pytf
祢	pyqi
祗	pyqy
祠	pynk
祯	pyhm
祧	pyqi
祺	pydw
禅	pyuf
禊	pydd
禚	pyuo
禧	pyfk
禳	pyye
忑	ghnu
忐	hnu
怼	cfnu
恝	dhvn
恚	ffnu
恧	dmjn
恁	wtfn
恙	ugnu
恣	uqwn
悫	fpwn
愆	tign
愍	natn
慝	aadn
憩	tdtn
憝	ybtn
懋	scnn
懑	iagn
戆	ujtn
肀	vhk
聿	vgk
沓	ijf
泶	ipiu
淼	iiiu
矶	dwn
矸	dfh
砀	dnrt
砉	dhdf
砗	dlh
砘	dgbn
砑	daht
斫	drh
砭	dtpy
砜	dwry
砝	dfcy
砹	dary
砺	ddgq
砻	dxyd
砟	dthf
砼	dwag
砥	dqay
砬	dug
砣	dpxn
砩	dxjh
硎	dgaj
硭	dayn
硖	dgud
硗	datq
砦	hxdf
硐	dmgk
硇	dtlr
硌	dtkg
硪	dtry
碛	dgmy
碓	dwyg
碚	dukg
碇	dpgh
碜	dcde
碡	dgxy
碣	djqn
碲	dyuh
碹	dpgg
碥	dyna
磔	dqgs
磙	duce
磉	dccs
磬	fnwd
磲	dias
礅	dybt
磴	dwgu
礓	dglg
礤	dawi
礞	dape
礴	daif
龛	wgky
黹	oiu
黻	oidy
黼	oisy
盱	hgfh
眄	hghn
眍	hary
盹	hgbn
眇	hitt
眈	hpqn
眚	tghf
眢	qbhf
眙	hckg
眭	hffg
眦	hhxn
眵	hqqy
眸	hctg
睐	hgus
睑	hwgg
睇	huxt
睃	hcwt
睚	hdff
睨	heqn
睢	hwyg
睥	hrtf
睿	hpgh
瞍	hehc
睽	hwgd
瞀	cnhh
瞌	hfcl
瞑	hpju
瞟	hsfi
瞠	hipf
瞰	hnbt
瞵	hoqg
瞽	fkuh
町	lsh
畀	lgjj
畎	ldy
畋	lty
畈	lrcy
畛	lwet
畲	wfil
畹	lpqb
疃	lujf
罘	ldhu
罡	lghf
罟	ldf
詈	lyf
罨	ldjn
罴	lfco
罱	lfmf
罹	lnwy
羁	lafg
罾	lulj
盍	fclf
盥	eilf
蠲	uwlj
钅	qtgn
钆	qnn
钇	qnn
钋	qhy
钊	qjh
钌	qbh
钍	qfg
钏	qkh
钐	qet
钔	qun
钗	qcyy
钕	qvg
钚	qdhy
钛	qdyy
钜	qang
钣	qrcy
钤	qwyn
钫	qyt
钪	qywn
钭	qufh
钬	qoy
钯	qcn
钰	qgyy
钲	qghg
钴	qdg
钶	qskg
钷	qakg
钸	qdmh
钹	qdcy
钺	qann
钼	qhg
钽	qjgg
钿	qlg
铄	qtni
铈	qymh
铉	qyxy
铊	qpxn
铋	qntt
铌	qnxn
铍	qby
铎	qcgh
铐	qftn
铑	qftx
铒	qbg
铕	qdeg
铖	qdnn
铗	qgud
铙	qatq
铘	qahb
铛	qivg
铞	qkmh
铟	qldy
铠	qmnn
铢	qtfy
铤	qtfp
铥	qtfc
铧	qwxf
铨	qwgg
铪	qwgk
铩	qrsy
铫	qqiy
铮	qqvh
铯	qqcn
铳	qycq
铴	qinr
铵	qpvg
铷	qvkg
铹	qape
铼	qgus
铽	qany
铿	qjcf
锃	qkgg
锂	qjfg
锆	qtfk
锇	qtry
锉	qwwf
锊	qefy
锍	qyck
锎	quga
锏	qujg
锒	qyvy
锓	qvpc
锔	qnnk
锕	qbsk
锖	qgeg
锘	qadk
锛	qdfa
锝	qjgf
锞	qjsy
锟	qjxx
锢	qldg
锪	qqrn
锫	qukg
锩	qugb
锬	qooy
锱	qvlg
锲	qdhd
锴	qxxr
锶	qlny
锷	qkkn
锸	qtfe
锼	qehc
锾	qegc
锿	qyey
镂	qovg
锵	quqf
镄	qxjm
镅	qnhg
镆	qajd
镉	qgkh
镌	qwyb
镎	qwgr
镏	qqyl
镒	quwl
镓	qpge
镔	qprw
镖	qsfi
镗	qipf
镘	qjlc
镙	qlxi
镛	qovh
镞	qytd
镟	qyth
镝	qyud
镡	qsjh
镢	qduw
镤	qoug
镥	qqgj
镦	qybt
镧	qusl
镨	quoj
镩	qpwh
镪	qxkj
镫	qwgu
镬	qawc
镯	qlqj
镱	qujn
镲	qpwi
镳	qoxo
锺	qtgf
矧	tdxh
矬	tdwf
雉	tdwy
秕	txxn
秭	ttnt
秣	tgsy
秫	tsyy
稆	tkkg
嵇	tdnm
稃	tebg
稂	tyvy
稞	tjsy
稔	twyn
稹	tfhw
稷	tlwt
穑	tfuk
黏	twik
馥	tjtt
穰	tyke
皈	rrcy
皎	rury
皓	rtfk
皙	srrf
皤	rtol
瓞	rcyg
瓠	dfny
甬	cej
鸠	vqgg
鸢	ayqg
鸨	xfqg
鸩	pqqg
鸪	dqgg
鸫	aiqg
鸬	hnqg
鸲	qkqg
鸱	qayg
鸶	xxgg
鸸	dmjg
鸷	rvyg
鸹	tdqg
鸺	wsqg
鸾	yoqg
鹁	fpbg
鹂	gmyg
鹄	tfkg
鹆	wwkg
鹇	usqg
鹈	uxhg
鹉	gahg
鹋	alqg
鹌	djng
鹎	rtfg
鹑	ybqg
鹕	deqg
鹗	kkfg
鹚	uxxg
鹛	nhqg
鹜	cnhg
鹞	etfg
鹣	uvjg
鹦	mmvg
鹧	oaog
鹨	nweg
鹩	dujg
鹪	wyog
鹫	yidg
鹬	cnhg
鹱	qgac
鹭	khtg
鹳	akkg
疒	uygg
疔	usk
疖	ubk
疠	ugqe
疝	umk
疬	udee
疣	udny
疳	ufd
疴	uskd
疸	ujgd
痄	uthf
疱	uqnv
疰	uygd
痃	uyxi
痂	uekd
痖	ugod
痍	ugxw
痣	ufni
痨	uape
痦	ugkd
痤	uwwf
痫	uusi
痧	uiit
瘃	ugey
痱	uhdd
痼	uldd
痿	utvd
瘐	uewi
瘀	uywu
瘅	uujf
瘌	uskj
瘗	uguf
瘊	uwnd
瘥	uuad
瘘	uovd
瘕	unhc
瘙	ucyj
瘛	udhn
瘼	uajd
瘢	utuc
瘠	uiwe
癀	uamw
瘭	usfi
瘰	ulxi
瘿	ummv
瘵	uwfi
癃	ubtg
瘾	ubqn
瘳	unwe
癍	ugyg
癞	uskm
癔	uujn
癜	unac
癖	unku
癫	ufhm
癯	uhhy
翊	ung
竦	uskg
穸	pwqu
穹	pwxb
窀	pwgn
窆	pwtp
窈	pwxe
窕	pwqi
窦	pwfd
窠	pwjs
窬	pwwj
窨	pwuj
窭	pwov
窳	pwry
衤	puyy
衩	pucy
衲	pumw
衽	putf
衿	puwn
袂	punw
袢	puug
裆	puiv
袷	puwk
袼	putk
裉	puvy
裢	pulp
裎	pukg
裣	puwg
裥	puuj
裱	puge
褚	pufj
裼	pujr
裨	purf
裾	pund
裰	pucc
褡	puak
褙	puue
褓	puws
褛	puov
褊	puya
褴	pujl
褫	purw
褶	punr
襁	puxj
襦	pufj
襻	pusr
疋	nhi
胥	nhef
皲	plby
皴	cwtb
矜	cnhn
耒	fsi
耔	fsbg
耖	fsit
耜	fsng
耠	fswk
耢	fsae
耥	fsik
耦	fsjy
耧	fsov
耩	fsaf
耨	fsdf
耱	fsod
耋	ftxf
耵	bsh
聃	bmfg
聆	bwyc
聍	bpsh
聒	btdg
聩	bkhm
聱	gqtb
覃	sjj
顸	fdmy
颀	rdmy
颃	ywdm
颉	fkdm
颌	wgkm
颍	xidm
颏	yntm
颔	wynm
颚	kkfm
颛	mdmm
颞	bccm
颟	agmm
颡	cccm
颢	jyim
颥	fdmm
颦	hhdf
虍	hhgn
虔	hyi
虬	jnn
虮	jwn
虿	gqju
虺	gqji
虼	jtnn
虻	jynn
蚨	jgy
蚍	jxxn
蚋	jmwy
蚬	jmqn
蚝	jen
蚧	jwjh
蚣	jwcy
蚪	jufh
蚓	jxhh
蚩	bhgj
蚶	jfg
蛄	jdg
蚵	jskg
蛎	jdgq
蚰	jmg
蚺	jmfg
蚱	jthf
蚯	jrg
蛉	jwyc
蛏	jcfg
蚴	jxet
蛩	awyj
蛱	jgud
蛲	jatq
蛭	jgcf
蛳	jjgh
蛐	jmag
蜓	jtfp
蛞	jtdg
蛴	jyjh
蛟	jury
蛘	juh
蛑	jctg
蜃	dfej
蜇	rrju
蛸	jieg
蜈	jkgd
蜊	jtjh
蜍	jwgs
蜉	jebg
蜣	junn
蜻	jgeg
蜞	jdwy
蜥	jsrh
蜮	jakg
蜚	hdhj
蜾	jjsy
蝈	jlgy
蜴	jjqr
蜱	jrtf
蜩	jmfk
蜷	jugb
蜿	jpqb
螂	jyvb
蜢	jblg
蝽	jdwj
蝾	japs
蝻	jfmf
蝠	jgkl
蝰	jdff
蝌	jtuf
蝮	jtjt
螋	jehc
蝓	jwgj
蝣	jytb
蝼	jovg
蝤	jusg
蝙	jyna
蝥	cnhj
螓	jdwt
螯	gqtj
螨	jagw
蟒	jada
蟆	jajd
螈	jdri
螅	jthn
螭	jyrc
螗	jovk
螃	jyuy
螫	fotj
蟥	jamw
螬	jgmj
螵	jsfi
螳	jipf
蟋	jton
蟓	jqke
螽	tujj
蟑	jujh
蟀	jyxf
蟊	cnhj
蟛	jfke
蟪	jgjn
蟠	jtol
蟮	juuk
蠖	jawc
蠓	jape
蟾	jqdy
蠊	jouw
蠛	jalw
蠡	xejj
蠹	gkhj
蠼	jhhc
缶	tfbj
罂	mmtb
罄	fnwb
罅	tfbf
舐	tdqa
竺	tff
竽	tgfj
笈	tbyu
笃	tcgf
笄	tgaj
笕	tmqb
笊	trhy
笫	ttnt
笏	tqrr
筇	tabj
笸	takf
笪	tjgf
笙	ttgf
笮	tthf
笱	tqkf
笠	tuf
笥	tngk
笤	tvkf
笳	tekf
笾	tepu
笞	tckf
筘	trkf
筚	txxf
筅	ttfq
筵	tthp
筌	twgf
筝	tqvh
筠	tfqu
筮	taww
筻	tgjr
筢	trcb
筲	tief
筱	twht
箐	tgef
箦	tgmu
箧	tagd
箸	tftj
箬	tadk
箝	trff
箨	trcg
箅	tlgj
箪	tujf
箜	tpwa
箢	tpqb
箫	tvhw
箴	tdgk
篑	tkhm
篁	trgf
篌	twnd
篝	tamf
篚	tahd
篥	tssu
篦	ttlx
篪	trhw
簌	tskw
篾	tlaw
篼	trqq
簏	toxx
簖	tonr
簋	tvlf
簟	tsjj
簪	taqj
簦	twgu
簸	tdwb
籁	tskm
籀	trql
臾	ewi
舁	eaj
舂	dwef
舄	eqou
臬	thsu
衄	tlng
舡	tuag
舢	tumh
舣	tuyr
舭	tuxx
舯	tukh
舨	turc
舫	tuyt
舸	tusk
舻	tuhn
舳	tumg
舴	tutf
舾	tusg
艄	tuie
艉	tune
艋	tubl
艏	tuuh
艚	tugj
艟	tuuf
艨	tuae
衾	wyne
袅	qyeu
袈	ekye
裘	giye
裟	iite
襞	nkue
羝	uqay
羟	ucag
羧	ucwt
羯	ujqn
羰	umdo
羲	ugty
籼	omh
敉	oty
粑	ocn
粝	odgq
粜	bmou
粞	osg
粢	uqwo
粲	hqco
粼	oqgb
粽	opfi
糁	ocde
糇	ownd
糌	othj
糍	ouxx
糈	onhe
糅	ocns
糗	othd
糨	oxkj
艮	vngy
暨	vaqg
羿	naj
翎	wycn
翕	wgkn
翥	ftjn
翡	hdhn
翦	uejn
翩	ynmn
翮	gkmn
翳	atdn
糸	xiu
絷	rvyi
綦	dwxi
綮	ynti
繇	etfi
纛	gxhi
麸	gqgy
麴	swwo
赳	fhnh
趄	fheg
趔	fhgj
趑	fhuw
趱	fhtm
赧	fobc
赭	fofj
豇	gkua
豉	gkuc
酊	sgsh
酐	sgfh
酎	sgfy
酏	sgbn
酤	sgdg
酢	sgtf
酡	sgpx
酰	sgtq
酩	sgqk
酯	sgxj
酽	sggt
酾	sggy
酲	sgkg
酴	sgws
酹	sgef
醌	sgjx
醅	sguk
醐	sgde
醍	sgjh
醑	sgne
醢	sgdl
醣	sgok
醪	sgne
醭	sgog
醮	sgwo
醯	sgyl
醵	sghe
醴	sgmu
醺	sgto
豕	gei
鹾	hlra
趸	gqkh
跫	awyh
踅	rrkh
蹙	dhih
蹩	itkh
趵	khqy
趿	khby
趼	khga
趺	khgy
跄	khwb
跖	khdg
跗	khwf
跚	khmg
跞	khti
跎	khpx
跏	khek
跛	khby
跆	khck
跬	khff
跷	khaq
跸	khxf
跣	khtq
跹	khtp
跻	khyj
跤	khur
踉	khyv
跽	khnn
踔	khhj
踝	khjs
踟	khtk
踬	khrm
踮	khok
踣	khuk
踯	khub
踺	khvp
蹀	khas
踹	khmj
踵	khtf
踽	khty
踱	khoc
蹉	khua
蹁	khya
蹂	khcs
蹑	khbc
蹒	khaw
蹊	khed
蹰	khdf
蹶	khdw
蹼	khog
蹯	khtl
蹴	khyy
躅	khlj
躏	khay
躔	khof
躐	khvn
躜	khtm
躞	khyc
豸	etyt
貂	evkg
貊	edjg
貅	ewsy
貘	eajd
貔	etlx
斛	qeuf
觖	qenw
觞	qetr
觚	qery
觜	hxqe
觥	qeiq
觫	qesk
觯	qeuf
訾	hxyf
謦	fnwy
靓	gemq
雩	ffnb
雳	fder
雯	fyu
霆	ftfp
霁	fyjj
霈	figh
霏	fhdd
霎	fuvf
霪	fief
霭	fyjn
霰	faet
霾	fejf
龀	hwbx
龃	hwbg
龅	hwbn
龆	hwbk
龇	hwbx
龈	hwbv
龉	hwbk
龊	hwbh
龌	hwbf
黾	kjnb
鼋	fqkn
鼍	kkln
隹	wyg
隼	wyfj
隽	wybr
雎	egwy
雒	tkwy
瞿	hhwy
雠	wyyy
銎	awyq
銮	yoqf
鋈	itdq
錾	lrqf
鍪	cnhq
鏊	gqtq
鎏	iycq
鐾	nkuq
鑫	qqqf
鱿	qgdy
鲂	qgyt
鲅	qgdy
鲆	qggf
鲇	qghk
鲈	qghn
稣	qgty
鲋	qgwf
鲎	ipqg
鲐	qgck
鲑	qgff
鲒	qgfk
鲔	qgde
鲕	qgdj
鲚	qgyj
鲛	qgur
鲞	ugqg
鲟	qgvf
鲠	qggr
鲡	qggy
鲢	qglp
鲣	qgjf
鲥	qgjf
鲦	qgts
鲧	qgti
鲨	iitg
鲩	qgpq
鲫	qgvb
鲭	qgge
鲮	qgft
鲰	qgbc
鲱	qghd
鲲	qgjx
鲳	qgjj
鲴	qgld
鲵	qgeq
鲶	qgwn
鲷	qgmk
鲺	qgnj
鲻	qgvl
鲼	qgfm
鲽	qgas
鳄	qgkn
鳅	qgto
鳆	qgtt
鳇	qgrg
鳊	qgya
鳋	qgcj
鳌	gqtg
鳍	qgfj
鳎	qgjn
鳏	qgli
鳐	qgeb
鳓	qgae
鳔	qgsi
鳕	qgfv
鳗	qgjc
鳘	txtg
鳙	qgoh
鳜	qgdw
鳝	qguk
鳟	qguf
鳢	qgmu
靼	afjg
鞅	afmd
鞑	afdp
鞒	aftj
鞔	afqq
鞯	afab
鞫	afqy
鞣	afcs
鞲	afaf
鞴	afae
骱	mewj
骰	mewc
骷	medg
鹘	meqg
骶	meqy
骺	merk
骼	metk
髁	mejs
髀	merf
髅	meov
髂	mepk
髋	mepq
髌	mepw
髑	melj
魅	rqcf
魃	rqcy
魇	ddrc
魉	rqcw
魈	rqce
魍	rqcn
魑	rqcc
飨	xtwv
餍	ddwv
餮	gqwv
饕	kgnv
饔	yxtv
髟	det
髡	degq
髦	deeb
髯	demf
髫	devk
髻	defk
髭	dehx
髹	dews
鬈	deub
鬏	deto
鬓	depw
鬟	dele
鬣	devn
麽	ossc
麾	osse
縻	ossi
麂	oxxw
麇	oxxt
麈	oxxg
麋	oxxo
麒	oxxw
鏖	oxxq
麝	oxxf
麟	oxxg
黛	wayo
黜	lfom
黝	lfoe
黠	lfok
黟	lfoq
黢	lfot
黩	lfod
黧	tqto
黥	lfoi
黪	lfoe
黯	lfoj
鼢	enuv
鼬	enum
鼯	enuk
鼹	enuv
鼷	enud
鼽	thlv
鼾	thlf
齄	thlg
丂	gnv
丄	hgd
丅	ghk
丆	dgt
丏	ghnn
丒	vygf
丗	gkgd
丟	gcu
丠	uxgf
両	gmmk
丣	gjan
並	uof
丩	nhk
丮	ngk
丯	ehk
丱	jnhg
丳	kkjk
丵	oufj
丷	uyt
丼	fjyi
乀	yyll
乁	gyi
乂	rty
乄	nyi
乆	nwi
乊	tue
乑	ithy
乕	rfmh
乗	tgas
乚	nnll
乛	nnll
乢	mnn
乣	xnn
乤	ghnb
乥	tunb
乧	ufnb
乨	cknn
乪	nld
乫	eknb
乬	annb
乭	dnb
乮	qtbn
乯	tufn
乲	uqwn
乴	rrnb
乵	unn
乶	snb
乷	iitn
乸	bxi
乹	fjnn
乺	rnrn
乻	ywun
乼	iygn
乽	ftjn
乿	exin
亀	qjjn
亁	fjfn
亂	ecmn
亃	oqgn
亄	fpgn
亅	hhll
亇	qhj
亊	guvh
亐	fnv
亖	fff
亗	mff
亙	ghng
亜	gkjg
亝	cccf
亞	gfgd
亣	yjj
亪	yogy
亯	yjf
亰	yjiu
亱	ywjg
亴	ypfv
亶	ylkg
亷	utvw
亸	ybuf
亹	yemg
亼	wgf
亽	wyu
亾	wnv
仈	wwy
仌	wwu
仏	wcy
仐	wfj
仒	wuu
仚	wmj
仛	wtan
仜	wag
仠	wfh
仢	wqyy
仦	wiy
仧	hwu
仩	whg
仭	wvyy
仮	wrcy
仯	witt
仱	wwyn
仴	weg
仸	wtdy
仹	wdhh
仺	wagf
仼	wgg
仾	wgxg
伀	wwcy
伂	wgmh
伃	wcnh
伄	wxhh
伅	wgbn
伆	wqrt
伇	wwcy
伈	wny
伋	wbyy
伌	wdbn
伒	wrh
伓	wdhy
伔	wpwn
伕	wgy
伖	wdcy
伜	wvfh
伝	wfcy
伡	wlh
伣	wmqn
伨	wqug
伩	wyy
伬	wnyy
伭	wyxy
伮	wvcy
伱	wwiy
伳	wann
伵	wlg
伷	wmg
伹	wegg
伻	wguf
伾	wdhg
伿	wkwy
佀	wng
佁	wckg
佂	wghg
佄	wfg
佅	wfy
佇	wpsh
佈	wdmh
佉	wfcy
佊	wby
佋	wvkg
佌	whxn
佒	wmdy
佔	whkg
佖	wntt
佡	wwmh
佢	wang
佦	wdg
佨	wqnn
佪	wlkg
佫	wtkg
佭	wtgh
佮	wwgk
佱	wfhf
佲	wqkg
併	wuah
佷	wvy
佸	wtdg
佹	wqdb
佺	wwgg
佽	wuqw
侀	wgaj
侁	wtfq
侂	wota
侅	wynw
來	swwi
侇	wgxw
侊	wigq
侌	wync
侎	woy
侐	wtlg
侒	wpvg
侓	wvgh
侕	wdmj
侖	wgma
侘	wpta
侙	waay
侚	wqjg
侜	wtuy
侞	wvkg
侟	wdhb
価	wsg
侢	wgmf
侤	wftn
侫	wynv
侭	wnyu
侰	wvtk
侱	wkgg
侲	wdfe
侳	wwwf
侴	wgnj
侶	wktk
侷	wnnk
侸	wgku
侹	wtfp
侺	wmwn
侻	wukq
侼	wfpb
侽	wlet
侾	wftb
俀	wevg
俁	wknd
係	wtxi
俆	wwgs
俇	wqtg
俈	wtfk
俉	wgkg
俋	wkcn
俌	wsy
俍	wyvy
俒	wpfq
俓	wgva
俔	whqn
俕	wpsy
俖	wdhk
俙	wrdh
俛	wqkq
俠	wdww
俢	wtet
俤	wuxt
俥	wlh
俧	wfny
俫	wgus
俬	wtcy
俰	wtkg
俲	wure
俴	waay
俵	wgey
俶	whic
俷	wecn
俹	wgfg
俻	wtlg
俼	wyce
俽	wrqw
俿	whwn
倀	wdey
倁	wtdk
倂	wtgf
倃	wthk
倄	wrde
倅	wywf
倆	wgmy
倇	wpqb
倈	wsww
倉	wyvk
倊	wwcn
個	wldg
倎	wmaw
倐	whto
們	wug
倓	wooy
倕	wtgf
倖	wfuf
倗	weeg
倛	wdwy
倝	fjwy
倞	wyiy
倠	wwyg
倢	wgvh
倣	wyty
値	wfhn
倧	wpfi
倫	wwga
倯	wswc
倰	wfwt
倱	wjxx
倲	wsjg
倳	wgkh
倴	wdfa
倵	wgay
倶	whgw
倷	wdfi
倸	wesy
倹	wwgw
倻	wbbh
倽	wwfk
倿	wuvg
偀	wamd
偁	wemf
偂	wuej
偄	wdmd
偅	wtgf
偆	wdwj
偉	wnkg
偊	wtky
偋	wnua
偍	wjgh
偐	wute
偑	wwtj
偒	wjgr
偓	wngf
偔	wkkn
偖	wftj
偗	with
偘	wkkk
偙	wyuh
偛	wtfe
偝	wuxe
偞	wans
偟	wrgg
偠	wsvg
偡	wdwn
偢	wtoy
偣	wujg
偤	wusg
偦	wnhe
偧	wdqq
偨	whxs
偩	wqmy
偪	wgkl
偫	wtff
偭	wdlf
偮	wkbg
偯	wyey
偰	wdhd
偱	wrfh
偲	wlny
偳	wmdj
側	wmjh
偵	whmy
偸	wwgb
偹	whtl
偺	wthj
偼	whvh
偽	wyto
傁	wehc
傂	wrhw
傃	wgxi
傄	wduh
傆	wdri
傇	wabg
傉	wdff
傊	wkmy
傋	wamf
傌	wcoy
傎	wfhw
傏	wovk
傐	wymk
傑	wqgs
傒	wexd
傓	wynn
傔	wuvw
傕	wpwy
傖	wwyk
傗	wyxl
傘	wwwf
備	wate
傚	wurt
傛	wpwk
傜	wetb
傝	wjng
傞	wuag
傟	wwcn
傠	wyfy
傡	wuug
傢	wpge
傤	wfal
傦	wmeg
傪	wcce
傫	wlxi
傭	wovh
傮	wgmj
傯	wtln
傰	wmee
傱	wtwh
傳	wgjf
傴	wakk
債	wgmy
傶	wdhi
傷	wtjr
傸	wdrr
傹	wujq
傼	wakg
傽	wujh
傾	wxdm
傿	wgho
僀	waqh
僁	wton
僂	wlvg
僃	waqe
僄	wsfi
僅	wakg
僆	wlpy
僇	wnwe
僈	wjlc
僉	wgkw
僊	wsdn
僋	wwym
僌	wlty
働	wtge
僎	wnnw
僐	wuuk
僑	wtdk
僒	wpwk
僓	wkhm
僔	wusf
僕	woug
僗	wooe
僘	wimt
僙	wamw
僛	wdww
僜	wwgu
僝	wnbb
僞	weto
僟	wxxw
僠	wtol
僡	wgjn
僢	wepg
僣	wggj
僤	wkkf
僥	wffq
僨	wfam
僩	wueg
僪	wcnk
僫	wgfn
僯	woqg
僰	smsw
僱	wyny
僲	wsqg
僴	wujg
僶	wxg
僷	waas
僸	wssi
價	wsmy
僺	wkks
僼	wmau
僽	wton
僾	wept
僿	wpaf
儀	wugy
儁	wwyn
儂	wmae
儃	wylg
億	wujn
儅	wipl
儈	wwgj
儉	wwgw
儊	wssh
儌	wryt
儍	wobt
儎	wfal
儏	whqo
儐	wpgm
儑	wjxo
儓	wfkf
儔	wfnf
儕	wyjg
儖	wahl
儗	wxth
儘	wvhl
儙	wkhp
儚	walq
儛	wtgg
儜	wpns
儝	woos
儞	wgwr
償	wipm
儠	wvln
儢	whln
儣	woaw
儤	wjai
儥	wflm
儦	woxo
儧	wggm
儨	wrrm
儩	wmjr
優	wdet
儫	wype
儬	wgeq
儭	wusq
儮	wdth
儯	wugo
儰	waeo
儱	wued
儲	wyfj
儳	wqky
儴	wyke
儵	whto
儶	wmwk
儷	wgmx
儸	wlxy
儹	wtfm
儺	waky
儻	wipo
儼	wkkt
儽	wlli
儾	wgke
兂	aqv
兇	rbqb
兊	wcqb
兌	wkqb
兎	tkqy
兏	dhqv
児	hjqb
兒	eqb
兓	aqaq
兗	ukqb
兘	fqck
兙	dqfk
兛	dqtf
兝	dqwv
兞	dqev
兟	tfqq
兠	ruxq
兡	dqdj
兣	dqdf
兤	igqw
兦	tynv
內	mtyi
兩	gmhy
兪	wgeb
兯	ubj
兲	gwu
兺	wvkx
兾	ulaw
兿	urvc
冃	mfd
冄	mfd
円	mhgd
冇	dmb
冊	mak
冋	mkd
冎	mnmb
冏	mwkd
冐	jef
冑	mef
冓	amff
冔	jkgf
冘	pqv
冚	pmj
冝	pegf
冞	pou
冟	prxb
冡	pfeu
冣	pbcu
冦	pfqc
冧	pssu
冨	pgkl
冩	peqo
冪	pajh
冭	duu
冮	uag
冴	uaht
冸	uugh
冹	udcy
冺	unan
冾	uwgk
冿	uvgh
凁	uskg
凂	uqkq
凃	uwgs
凅	uldg
凈	uevh
凊	ugeg
凍	usjg
凎	uqg
凐	usfg
凒	umgu
凓	ussy
凔	uwyk
凕	upju
凖	uwyf
凗	umwy
凘	udwr
凙	ulff
凚	ussi
凜	uylt
凞	utao
凟	uflm
凢	twv
凣	hwv
凥	nwv
処	twv
凧	wmhk
凨	wfci
凩	wsi
凪	whd
凬	wgjd
凮	wdjd
凱	mgkw
凲	wuvw
凴	ucow
凷	fbk
凾	bkcb
刄	vyi
刅	vwi
刉	tnjh
刋	tdjh
刌	fjh
刏	rjh
刐	myjh
刓	fqjh
刔	nwjh
刕	vvvr
刜	xjjh
刞	egjh
刟	vkjh
刡	najh
刢	wycj
刣	ckjh
別	kqjh
刦	fcjh
刧	fcvt
刪	majh
刬	gajh
刯	gjgj
刱	fjvw
刲	ffjh
刴	bsjh
刵	bjh
刼	fcvy
刾	gudj
剄	gvaj
剅	gkuj
剆	yvjh
則	mjh
剈	kejh
剉	wwfj
剋	dqjk
剎	rsyj
剏	uavy
剒	ajjh
剓	tqtv
剕	hdhj
剗	aajh
剘	dwjh
剙	uavw
剚	gkvj
剛	mumj
剝	xijh
剟	cccj
剠	yijh
剢	geyj
剣	wgkj
剤	yjjh
剦	djnj
剨	dhdj
剫	oacj
剬	mdmj
剭	ngcj
剮	mnmj
剰	tgaj
剱	wgky
剳	awgj
剴	mgkj
創	wyvj
剶	xejh
剷	uttj
剸	gjhj
剹	nwej
剺	ftdv
剻	meej
剼	cccj
剾	akkj
劀	cnhj
劃	vflj
劄	twgj
劅	lqjj
劆	ouvj
劇	hgej
劉	qyvj
劊	wglj
劋	kkkj
劌	hdgj
劍	wgkj
劎	wgkv
劏	ipkj
劑	yjjh
劒	wgky
劔	wgky
劕	rrmj
劖	qkxj
劗	tfqj
劘	ossj
劙	xejj
劚	nilj
劜	enn
劤	ret
劥	ywet
劦	eeer
劧	ret
劮	tget
劯	det
劰	ret
労	iper
劵	uger
劶	rgke
劷	uet
劸	ffet
効	uret
劺	ctge
劻	aget
劼	fket
劽	gqje
勀	dqet
勁	gvae
勂	tfke
勄	txet
勅	sket
勆	yvet
勈	ceet
勊	dqee
勌	ugbe
勍	yiet
勎	fwfe
勏	uket
勑	swwe
勓	xxre
勔	dlje
動	tgje
勗	jege
務	cnhe
勚	anme
勛	kmet
勜	wcne
勝	euge
勞	oope
勠	nwee
勡	sfie
勢	fwfe
勣	gmet
勥	xkje
勦	vjse
勧	tgwe
勨	qkee
勩	anme
勪	tdke
勫	tole
勬	ugxe
勭	ujfe
勮	hgee
勯	ylke
勱	ajme
勲	tgjo
勳	tgle
勴	hlne
勵	daje
勶	tyce
勷	ykke
勸	akke
勻	qfd
勼	qvv
勽	qwi
匁	qri
匂	qxv
匃	qwnv
匄	qynv
匇	qqi
匉	qguf
匊	qoi
匋	qtfb
匌	qwgk
匎	qdjn
匑	qtmx
匒	qawk
匓	qvwc
匔	qtmk
匘	xvtr
匛	aqyi
匜	abv
匞	aad
匟	aywv
匢	aqre
匤	agyi
匥	acak
匧	adww
匨	aufd
匩	abhg
匫	aqrj
匬	awgj
匭	alvv
匯	aiwy
匰	akkf
匱	akhm
匲	adkk
匳	awgw
匴	atha
匵	aflm
匶	aawe
匷	ahhy
匸	agn
匼	awgk
匽	ajvd
區	akkk
卂	nfk
卄	aghh
卆	vfj
卋	faf
卌	glk
卍	nhgh
卐	nghg
協	feee
単	ijfj
卙	dwnf
卛	yxxf
卝	hghg
卥	hlry
卨	hmnk
卪	byi
卬	qbh
卭	abh
卲	vkbh
卶	qqbh
卹	tlbh
卻	wwkb
卼	gqqb
卽	rxbh
卾	kkfb
厀	swib
厁	wgsb
厃	qdr
厇	dtav
厈	dfk
厊	daht
厎	dqay
厏	dthf
厐	ddxy
厑	dkxv
厒	dtfb
厓	dffd
厔	dgcf
厖	ddny
厗	duk
厙	dlk
厛	dkrk
厜	dtgf
厞	dhdd
厠	dmjk
厡	drii
厤	dtti
厧	dfhw
厪	dakg
厫	dgqt
厬	djtk
厭	djed
厯	dssy
厰	dimt
厱	dwgw
厲	dajy
厳	idnt
厴	djel
厵	drii
厷	dcu
厸	ccy
厹	vcu
厺	dcu
厼	ciu
厽	cccu
厾	nfci
叀	gmcu
參	ccce
叄	cccd
叅	cccn
叆	fcec
叇	fcvp
収	nhcy
叏	nhcu
叐	tdci
叒	cccu
叓	gkhc
叕	cccc
叚	nhfc
叜	pocu
叝	fcbc
叞	nfic
叡	hpgc
叢	oufc
叧	kvr
叴	vkf
叺	ktyy
叾	bkf
叿	kag
吀	ktfh
吂	ynkf
吅	kkg
吇	kbg
吋	kfy
吔	kbn
吘	ktfh
吙	koy
吚	kvtt
吜	knhg
吢	nkf
吤	kwjh
吥	kdhy
吪	kwxn
吰	kdcy
吳	kndu
吶	kmty
吷	knwy
吺	kwcy
吽	ktgh
吿	tgkf
呁	kqug
呂	ktkf
呄	bdf
呅	kyy
呇	ikf
呉	kngw
呌	kufh
呍	kfcy
呎	knyy
呏	ktah
呑	tdkf
呚	kty
呝	kynn
呞	kngk
呟	kyxy
呠	ksgg
呡	knan
呣	kxy
呥	kmfg
呧	kqay
呩	kfiy
呪	kkqn
呫	khkg
呬	klg
呭	kann
呮	kkwy
呯	kguf
呰	hxkf
呴	kqkg
呹	ktgy
呺	kkgn
呾	kjgg
呿	kfcy
咁	kfg
咃	kwbn
咅	ukf
咇	kntt
咈	kxjh
咉	kmdy
咊	kty
咍	kckg
咑	krsh
咓	kgny
咗	kdag
咘	kdmh
咜	kpxn
咞	kgah
咟	kdjg
咠	kbf
咡	kbg
咢	kkfn
咥	kgcf
咮	ktfy
咰	kqjg
咲	kudy
咵	kdfn
咶	ktdg
咷	kqiy
咹	kpvg
咺	kgjg
咼	mnmk
咾	kftx
哃	kmgk
哅	kqrb
哊	kdeg
哋	kfbn
哖	ktgh
哘	ktgs
哛	kxwv
哠	ktfk
員	kmu
哢	kgah
哣	kgku
哤	kdny
哫	kkhy
哬	kwsk
哯	khqn
哰	kptg
哱	kfpb
哴	kyvy
哵	kkej
哶	khgf
哷	kefy
哸	kevg
哹	kebg
哻	kjfh
哾	kukq
唀	ktbt
唂	kwwk
唃	kqeh
唄	kmy
唅	kwyk
唈	kkcn
唊	kdww
唋	kwgs
唌	kthp
唍	kpfq
唎	ktjh
唒	ksgg
唓	klh
唕	krfh
唖	kgkg
唗	kfhy
唘	dckf
唙	kqto
唚	kvpc
唜	gskx
唝	kamy
唞	kruf
唟	fckx
唡	kgmw
唥	kuwc
唦	kiit
唨	kbeg
唩	ktvg
唫	kqg
唭	kdwy
唲	keqn
唴	kunn
唵	kdjn
唶	kajg
唸	kwyn
唹	kywu
唺	kmaw
唻	ksww
唽	ksrh
啀	kdff
啂	kebn
啅	khjh
啇	yumd
啈	kfuf
啋	kesy
啌	kpwa
啍	kybg
啎	tfgk
問	ukd
啑	kgvh
啒	knbm
啓	yntk
啔	ynak
啗	kqeg
啘	kpqb
啙	hxkk
啚	kflk
啛	kgvv
啝	ktkg
啞	kgfg
啟	ynkt
啠	rrkf
啢	kgmy
啣	ktgb
啨	kgeg
啩	kffh
啫	kftj
啯	klgy
啰	klqy
啱	kmdg
啲	krqy
啳	kugb
啴	kujf
啹	kndg
啺	kjgr
啽	kwga
啿	kdwn
喅	kjug
喆	fkfk
喌	kkyh
喍	khxs
喎	kmnk
喐	kdeb
喒	kthj
喓	ksvg
喕	kdlf
喖	ksdg
喗	kplh
喚	kqmd
喛	kegc
喞	krxb
喠	ktgf
喡	knkg
喢	ktfe
喣	kqko
喤	krgg
喥	koac
喦	kkkm
喨	kypw
喩	kwgb
喪	fkke
喫	kdhd
喬	tdkk
喭	kute
單	kkjf
喯	kdfa
喰	kwyv
喲	kxqy
喴	kdgv
営	ipkk
喸	skxb
喺	kwti
喼	kqvn
喿	kkks
嗀	fpgc
嗁	krhw
嗂	ketb
嗃	kymk
嗆	kwyk
嗇	fwwk
嗈	kvkc
嗊	kamy
嗋	keee
嗎	kcoy
嗏	kaws
嗐	kpdk
嗕	kdff
嗗	kmeg
嗘	kexd
嗙	kyuy
嗚	kqoy
嗛	kuvw
嗞	kuxx
嗠	ebtk
嗢	kjlg
嗧	ekwa
嗩	kimy
嗭	fhkx
嗮	kjsg
嗰	kwld
嗱	kwgr
嗴	kunc
嗶	kjag
嗸	gqtk
嗹	klpy
嗺	kmwy
嗻	koao
嗼	kajd
嗿	kwym
嘂	kknk
嘃	kovh
嘄	kqsy
嘅	kvaq
嘆	kakg
嘇	kcce
嘊	kmdf
嘋	kftt
嘍	klvg
嘐	knwe
嘑	khtf
嘒	kdhv
嘓	klag
嘔	kakk
嘕	kgho
嘖	kgmy
嘗	ipkj
嘙	kibv
嘚	ktjf
嘜	kswq
嘝	kqef
嘠	kdea
嘡	kipf
嘢	kjfh
嘥	kthh
嘦	kwsv
嘨	kvoj
嘩	kagg
嘪	klmy
嘫	kqdo
嘮	kooe
嘯	kvfj
嘰	kxxw
嘳	kkhm
嘵	kffq
嘷	kthf
嘸	ktgo
嘺	ktdk
嘼	kklk
嘽	kkkf
嘾	ksjh
噀	knnw
噁	kgfn
噂	kusf
噃	ktol
噄	kdhi
噅	keto
噆	kaqj
噇	kujf
噈	kyiy
噉	knbt
噊	kcnk
噋	kybt
噏	kwgn
噐	kkak
噑	krif
噒	koqg
噓	khjg
噕	etnk
噖	kggn
噚	kvaf
噛	khob
噝	kxxi
噞	kwgw
噟	owwk
噠	kfup
噡	kqdy
噣	klqj
噥	kmae
噦	khdh
噧	kajy
噭	kryt
噮	klge
噯	kept
噰	kyxy
噲	kwgj
噳	khkd
噴	kfam
噵	uthk
噷	kujw
噸	kgbm
噹	kipl
噺	kusr
噽	fkug
噾	kpwj
噿	knyf
嚀	kpns
嚁	knwy
嚂	kahl
嚃	klip
嚄	kawc
嚇	kfoo
嚈	kdjd
嚉	kouf
嚊	kthj
嚋	kfnf
嚌	kyjg
嚍	kvhl
嚐	kipj
嚑	ktgo
嚒	kosx
嚔	kfph
嚕	kqoj
嚖	kdhn
嚗	kjai
嚘	kdet
嚙	khbh
嚚	kkak
嚛	krxs
嚜	klff
嚝	koaw
嚞	fkfk
嚟	ktqi
嚠	kqyj
嚡	kaff
嚢	gkhe
嚤	kosr
嚥	kako
嚦	kdth
嚧	khll
嚨	kued
嚩	kxsf
嚪	kuqe
嚫	kusq
嚬	khhm
嚭	fkuk
嚮	xtyk
嚰	kosd
嚱	khga
嚲	ybkf
嚳	errk
嚴	kkdt
嚵	kqky
嚶	kmmv
嚸	klfk
嚹	ktff
嚺	klup
嚻	kkdk
嚽	kgqm
嚾	kaky
嚿	kawe
囀	klgf
囁	kbbb
囂	kkdk
囃	kywy
囄	kyry
囅	kkje
囆	kajj
囇	kgmx
囈	kafc
囉	klxy
囋	ktfm
囌	kaqt
囍	fkuk
囎	kmuj
囏	akgk
囐	khgd
囑	knij
囒	kaul
囓	kdhb
囕	kahq
囖	ktly
囘	mnv
囙	lnd
囜	lci
団	lfi
囥	lywv
囦	lii
囧	lwmv
囨	ldhi
囩	lfci
囪	tlry
囬	ljfd
囮	lwxv
囯	lgd
囲	lfjk
図	luri
囶	lwfd
囷	lti
囸	lghd
囻	lnav
囼	lckd
圀	lwye
圁	lyd
圂	lgei
圅	cluf
圇	lwga
國	lakg
圌	lmdj
圍	lnkg
圎	lcmi
圏	lugn
圐	llye
圑	lsfi
園	lfke
圓	lkmi
圔	lfcl
圕	lvfj
圖	lkfk
圗	lcff
團	lgjf
圙	lwdf
圚	lkhm
圛	llff
圝	lyxx
圞	lyxs
圠	fnn
圡	fyi
圢	fsh
圤	fhy
圥	fqb
圦	ftyy
圧	dfd
圫	ftan
圱	tdfg
圲	ftfh
圴	fqyy
圵	fhg
圶	dff
圷	fghy
圸	fmh
圼	jff
圽	fqrt
圿	fwjh
坁	fqan
坃	ffqn
坄	fwcy
坅	fwyn
坆	fty
坈	fpwn
坉	fgbn
坋	fwvt
坒	xxff
坓	fjff
坔	iff
坕	rhyf
坖	fqff
坘	fgxg
坙	gvff
坢	fugh
坣	ipff
坥	fegg
坧	fdg
坬	frcy
坮	fckg
坰	fmkg
坱	fmdy
坲	fxjh
坴	fwff
坵	frg
坸	fqkg
坹	fpwy
坺	fdcy
坽	fwyc
坾	fpsh
坿	fwfy
垀	ftuf
垁	ftdy
垇	fhng
垈	wayf
垉	fqnn
垊	fnan
垍	fthg
垎	ftkg
垏	fvgh
垐	uqwf
垑	fqqy
垔	sff
垕	rgkf
垖	ftng
垗	fqiy
垘	fwdy
垙	figq
垚	ffff
垜	fbsy
垝	fqdb
垞	fpta
垟	fuh
垥	fwgk
垨	fpfy
垪	fuah
垬	fawy
垯	fdpy
垰	fhgh
垱	fivg
垳	ftgs
垵	fpvg
垶	fuh
垷	fhqn
垹	fdtb
垺	febg
垻	fmy
垼	twcf
垽	irff
垾	fjfh
垿	foch
埀	tguf
埁	fmwn
埄	ftdh
埅	byff
埆	fqeh
埇	fceh
埈	fcwt
埉	fdww
埊	miff
埌	fyvy
埍	fkeg
埐	fvpc
埑	rrff
埓	fefy
埖	fawx
埗	fhht
埛	fmwk
埜	ssff
埞	fpgh
埡	fgfg
埢	fugb
埣	fywf
埥	fgeg
埦	fpqb
埧	fhwy
埨	fwga
埩	fqvh
埪	fpwa
埫	fimk
埬	fsjg
埮	fooy
埰	fesy
埱	fhic
埲	fdwg
埳	fqeg
埵	ftgf
埶	fwfy
執	fufy
埻	fybg
埼	fdsk
埾	bcff
埿	inxf
堁	fjsy
堃	yyff
堄	feqn
堅	ahnf
堈	fmum
堉	fyce
堊	gfgf
堌	fldg
堎	ffwt
堏	syff
堐	fdff
堒	fjxx
堓	fmdf
堔	fpws
堖	fvtr
堗	fpwd
堘	fugf
堚	fplh
堛	fgkl
堜	fslg
堝	fmnk
堟	fxey
堢	fwks
堣	fjmy
堥	cnhf
堦	fxxr
堧	fdmd
堨	fjqn
堩	fngg
堫	frbt
堬	fwgj
堭	frgg
堮	fkkn
堯	fffq
報	fufc
堲	vbff
堳	fnhg
場	fjgr
堶	fdae
堷	fujg
堸	fwtj
堹	ftgf
堺	flwj
堻	ivgf
堼	ffff
堽	flgh
堾	fdwj
堿	fdgk
塀	fnua
塁	liff
塂	fawn
塃	fayk
塅	fthc
塆	fyox
塇	fpgg
塈	vaqf
塉	fiwe
塊	frqc
塋	oopf
塎	fpwk
塏	fmgu
塐	fgxi
塒	fjff
塓	fpju
塕	fwcn
塖	ftux
塗	iwgf
塙	fymk
塚	fpgy
塛	fssy
塜	fpfe
塝	fyuy
塟	agqf
塠	ftnp
塡	fxhw
塢	fqoy
塣	ikgf
塤	fkmy
塦	blff
塧	fuwl
塨	fawn
塩	ftkl
塪	feeg
塭	fjlg
塮	ftmf
塯	fqyl
塰	itxf
塱	yvef
塲	ftjr
塳	ftdp
塴	fmee
塵	oxxf
塶	foxx
塷	fhlo
塸	fakk
塹	lrff
塺	ossf
塻	fajd
塼	fgjf
塽	fdrr
塿	flvg
墂	fsfi
墄	fdhi
墆	faqh
墇	fujh
墈	fdwe
墊	fuff
墋	fcce
墌	foao
墍	rxaf
墎	fybb
墏	uqff
墐	fakg
墑	fyud
墔	fmwy
墕	fgho
墖	fwgl
増	fulj
墘	ffjn
墛	fnff
墜	buef
墝	fffq
墠	fkkf
墡	fuuk
墢	fwxc
墣	foug
墤	fkhm
墥	fujf
墦	ftol
墧	ftdk
墪	ybtf
墫	fusf
墬	bxef
墭	fdnl
墮	bdaf
墯	ndaf
墰	fsjh
墱	fwgu
墲	ftgo
墳	ffam
墴	famw
墵	fffc
墶	ffup
墷	fagg
墸	fafj
墹	fujg
墺	ftmd
墻	ffwk
墽	fryt
墾	evff
墿	flff
壀	fnku
壂	nawf
壃	fglg
壄	scnf
壆	errf
壇	fylg
壈	fylt
壉	fhge
壊	ffle
壋	fipl
壌	fuae
壍	ilrf
壎	ftgo
壏	fahl
壐	gwmf
壒	fafl
壓	djef
壔	ffnf
壖	ffdj
壗	fvhl
壘	lllf
壙	foaw
壚	fhll
壛	fuqe
壜	fjfc
壝	fkhp
壞	fyle
壟	uegf
壠	fued
壡	hpgf
壢	fdth
壣	fbxg
壥	fdlf
壦	faky
壧	fkkt
壨	lllf
壩	ffae
壪	fyxx
壭	fbj
壯	ufg
壱	fpxb
売	fpqb
壴	fkuf
壵	ffff
壷	fpkg
壸	fpgo
壺	fpfg
壻	fnhe
壼	fpgg
壽	fnaf
壾	fkun
壿	fusf
夀	fnkf
夁	flld
夃	bci
夅	tgj
夆	tdhj
夈	tou
変	yotu
夊	qyi
夋	cwtu
夌	fwtu
夎	wwft
夐	qmwt
夑	yoot
夒	dhht
夓	edht
夗	qbn
夘	qbh
夛	vqu
夝	qtgg
夞	qhkx
夠	qqqk
夡	qqfk
夢	alpq
夣	yclq
夦	dwnq
夨	ngyi
夬	nwi
夰	djj
夲	dfj
夳	dff
夵	diu
夶	ddy
夻	dkf
夽	dfcu
夾	dwwi
夿	dcb
奀	dhdu
奃	dqay
奅	dqtb
奆	danf
奊	ffny
奌	hkdu
奍	ugjj
奐	qmwd
奒	dynw
奓	dqqu
奙	cdjn
奛	djef
奜	hdhd
奝	dmfk
奞	dwyf
奟	deef
奡	dhdj
奣	gdje
奤	ddlf
奦	cnhd
奧	tmtd
奨	uefd
奩	dakk
奪	dwyf
奫	dijg
奬	uqfd
奭	ddjj
奮	dwyl
奯	dhdh
奰	llld
奱	yxxd
奲	dftf
奵	vsh
奷	vtfh
奺	vqyy
奻	vvg
奼	vtan
奾	vmh
奿	vyvd
妀	nvg
妅	vag
妉	vpqn
妋	vgy
妌	vfjh
妎	vwjh
妏	vyy
妐	vwcy
妑	vcn
妔	vywn
妕	vkhh
妘	vfcy
妚	vdhy
妛	bhgv
妜	vnwy
妝	uvg
妟	jvf
妠	vmwy
妡	vrh
妢	vwvt
妦	vdhh
妧	vfqn
妬	vdg
妭	vdcy
妰	vthf
妱	vvkg
妳	vqiy
妴	qbvf
妵	vygg
妶	vyxy
妷	vtgy
妸	vskg
妺	vgsy
妼	vntt
妽	vjhh
妿	ekvf
姀	vty
姁	vqkg
姂	vtpy
姃	vghg
姄	vnan
姅	vugh
姇	wfvf
姈	vwyc
姉	vgmh
姌	vmfg
姍	vmah
姎	vmdy
姏	vfg
姕	hxvf
姖	vang
姙	vwtf
姛	vmgk
姞	vfkg
姟	vynw
姠	vtmk
姡	vtdg
姢	vceg
姤	vrgk
姦	vvvf
姧	vvfh
姩	vtgh
姪	vgcf
姫	vahh
姭	eeev
姮	vgjg
姯	vigq
姰	vqjg
姱	vdfn
姲	vpvg
姳	vqkg
姴	gqjv
姵	vwgh
姶	vwgk
姷	vdeg
姸	vgdf
姺	vtfq
姼	vqqy
姽	vqdb
姾	vwgg
娀	vadt
娂	vawy
娊	vhqn
娋	vieg
娍	vdnn
娎	rrvf
娏	vdny
娐	vebg
娒	vtxy
娔	vdqn
娕	vskg
娖	vkhy
娗	vtfp
娙	vgva
娚	vlet
娛	vknd
娝	vdhk
娞	vevg
娡	vfny
娢	vwyk
娤	ufvf
娦	vrwy
娧	vukq
娨	vjfh
娪	vgkg
娫	vthp
娬	vgay
娭	vctd
娮	vyg
娯	vknw
娰	vwnw
娳	vtjh
娵	vbcy
娷	vtgf
娸	vdwy
娹	vxyx
娺	vccc
娻	vsjg
娽	vviy
娾	vdff
娿	bskv
婁	lvf
婂	vrmh
婃	vpfi
婄	vukg
婅	vqoy
婇	vesy
婈	vfwt
婋	vhwn
婌	vhic
婍	vdsk
婎	vwyg
婏	vqky
婐	vjsy
婑	vtvg
婒	vooy
婓	hdhv
婔	vhdd
婖	vgdn
婗	veqn
婘	vugb
婙	vqvh
婛	vyiy
婜	ahnv
婝	vpgh
婞	vfuf
婟	vldg
婠	vpng
婡	vsww
婣	vjgg
婤	vmfk
婥	vhjh
婦	vvph
婨	vwga
婩	vmdf
婫	vjxx
婬	vetf
婭	vgfg
婮	vndg
婯	gmyv
婰	vmaw
婱	xyxv
婲	vawx
婳	vglb
婸	vjgr
婹	vsvg
婻	vfmf
婼	vadk
婽	vnhc
婾	vwgb
媀	vjmy
媁	vnkg
媂	vyuh
媃	vcns
媄	vugd
媅	vdwn
媆	vdmd
媇	vusy
媈	vplh
媉	vngf
媊	vuej
媋	vdwj
媌	valg
媍	vqmy
媎	vftj
媏	vmdj
媐	ahkv
媑	vtgf
媓	vrgg
媔	vdlf
媕	vwga
媖	vamd
媗	vpgg
媘	vxxr
媙	vdgv
媜	vhmy
媝	tovf
媞	vjgh
媟	vans
媠	vdae
媡	vslg
媢	vjhg
媣	vivs
媤	vlny
媥	vyna
媦	vleg
媧	vmnk
媨	vusg
媩	vdeg
媫	vhvh
媬	vwks
媭	edmv
媮	vwgj
媯	vyto
媰	vqbt
媱	vetb
媴	vfke
媶	vabg
媷	vdff
媹	vqyl
媺	vmgt
媻	tuwv
媼	vlwl
媽	vcoy
媿	vrqc
嫀	vdwt
嫃	vfhw
嫄	vdri
嫅	vuag
嫆	vpwk
嫇	vpju
嫈	oopv
嫊	vgxi
嫋	vxuu
嫍	veeg
嫎	vyuy
嫏	vyvb
嫐	vlev
嫑	dhsv
嫓	vqmx
嫕	vatn
嫗	vakk
嫙	vyth
嫚	vjlc
嫛	atdv
嫝	vovi
嫞	vovh
嫟	vaak
嫢	ghqv
嫤	vakg
嫥	vgjf
嫧	vgmy
嫨	vakg
嫪	vnwe
嫬	voao
嫭	vhtf
嫮	vffn
嫯	gqtv
嫰	vskw
嫲	voss
嫳	itvf
嫴	vduh
嫵	vtgo
嫶	vwyo
嫷	vbde
嫸	vuuk
嫹	vamw
嫺	vueg
嫻	vusy
嫼	vlfo
嫽	vdui
嫾	voqg
嫿	vvfg
嬀	veto
嬁	vwgu
嬂	vyuj
嬃	edmv
嬄	vfpu
嬅	vagg
嬆	vwgn
嬇	vkhm
嬈	vffq
嬊	akuv
嬋	vkkf
嬌	vtdk
嬍	vmgt
嬎	vqkg
嬏	vtol
嬐	vwgw
嬑	vujn
嬒	vwgj
嬓	vryt
嬔	vqkg
嬕	vlff
嬘	vuep
嬙	vfwk
嬚	vouw
嬛	vlge
嬜	ujqv
嬝	vqye
嬞	vatf
嬟	vugy
嬠	vkks
嬡	vept
嬢	vuae
嬣	vpns
嬤	vosx
嬥	vnwy
嬦	vfnf
嬧	vvhl
嬨	vuxn
嬩	vegw
嬪	vpgm
嬫	voos
嬬	vfdj
嬭	vgwr
嬮	djev
嬯	vfkf
嬰	mmvf
嬱	ilrv
嬳	vawc
嬵	vxrh
嬶	vthj
嬸	vptl
嬹	vemw
嬺	vaan
嬻	vflm
嬼	vqyj
嬽	vlhd
嬾	vskm
嬿	vako
孁	fkkv
孂	vtvl
孃	vyke
孄	vusl
孅	vwwg
孆	vmmv
孇	vwyc
孈	vmwk
孉	vaky
孊	vosd
孋	vgmx
孌	yxxv
孍	vkkt
孎	vnij
孏	vaul
孒	bgd
孖	bbg
孞	bnu
孠	ngkb
孡	bckg
孧	xebf
孨	bbbf
孫	btxi
孭	bmy
孮	bpfi
孯	ahnb
孲	bgfg
孴	bbbj
孶	yxyb
孷	ftdb
學	errb
孹	nkub
孻	bvhl
孼	bttb
孾	bmmv
孿	yxxb
宂	pwb
宆	pxb
宊	pdu
宍	puu
宎	ptdu
宐	phng
宑	pfjj
宒	peb
宔	pygf
宖	pxcu
実	pdwu
宧	pahh
宨	pqiu
宩	pou
宬	pdnb
宭	pvtk
宮	pktk
宯	pftb
宱	pwtf
宲	pksu
宷	ptou
宺	pkgk
宻	pcum
宼	pfqv
寀	pesu
寁	pgvh
寃	pqky
寈	pgef
寉	pwyf
寊	phmu
寋	pawb
寍	pnlf
寎	pugw
寏	pqmd
寑	pwvc
寔	pjgh
寕	pdls
寖	pivc
寗	pntf
寘	pfhw
寙	prcy
寚	pgtb
寛	pahq
寜	pnlh
寠	plvf
寢	puvc
寣	puyf
實	pxmu
寧	pnls
審	ptol
寪	peto
寫	peqo
寬	pahy
寭	pgjn
寯	pwyn
寱	puts
寲	pxth
寳	pgqm
寴	pusq
寵	pued
寶	pgtm
寷	pmdu
寽	efu
対	yfy
尀	akfy
専	gmfu
尃	sfu
尅	dqfi
將	uqfy
專	gjhf
尋	vakf
尌	fkuf
對	ougf
導	uthf
尐	inb
尒	wiu
尓	tiu
尗	hiu
尙	imkf
尛	iiiu
尞	duji
尟	jght
尠	dwnt
尡	igqx
尣	wqb
尦	wqqy
尨	dney
尩	wqgd
尪	dngd
尫	gqgd
尭	fagq
尮	dnbs
尯	dnqb
尰	dntf
尲	dnuw
尳	dnme
尵	dnkm
尶	gqal
尷	dnal
屃	nmi
屄	npwi
屆	nfbk
屇	nld
屌	nkmh
屍	ngqx
屒	ndfe
屓	nmi
屔	rnxn
屖	nuk
屗	nefi
屘	nebd
屚	nfi
屛	ntgf
屜	ntan
屝	nhdd
屟	nans
屢	nlvd
層	nulj
屧	ntas
屨	ntlv
屩	nttk
屪	npdi
屫	nutk
屬	nilj
屭	nmmm
屰	ubtr
屲	tmj
屳	tymj
屴	mer
屵	mdr
屶	mvr
屷	mbt
屸	mag
屻	mvyy
屼	mgqn
屽	mfh
屾	mmh
岀	bmk
岃	mvyu
岄	meg
岅	mrcy
岆	mtdy
岇	mqbj
岉	mqrt
岊	cmj
岋	mbyy
岎	mwvt
岏	mfqn
岒	mwyn
岓	mrh
岕	mwjj
岝	mthf
岞	mthf
岟	mmdy
岠	mang
岡	mumk
岤	mpwy
岥	mby
岦	muf
岧	mvkf
岨	megg
岪	mxjj
岮	mpxn
岯	mdhg
岰	mxet
岲	mkqn
岴	mrg
岶	mrg
岹	mvkg
岺	mwyc
岻	mqay
岼	mguf
岾	mhkg
峀	mmf
峂	mtuy
峃	ipmj
峅	mcah
峆	mwgk
峇	mwgk
峈	mtkg
峉	mtkf
峊	tnmj
峌	mgcf
峍	mvgh
峎	mvu
峏	mdmj
峐	mynw
峑	mwgf
峓	mgxw
峔	mftx
峕	myjf
峖	mpvg
峗	mqdb
峘	mgjg
峚	mdff
峛	mgqj
峜	mwhf
峝	mmgk
峞	mqdb
峟	mdef
峠	mhgh
峢	mgqj
峣	matq
峧	mury
峩	mtry
峫	mahb
峬	msy
峮	mvtk
峯	mtdh
峱	qtnm
峲	mtjj
峳	mwht
峴	mhqn
峵	mpdc
島	qmk
峷	muj
峸	mdnn
峹	wgsm
峺	mgjr
峼	mtfk
峽	mdww
峾	irmj
峿	mgkg
崀	myvu
崁	mfqw
崄	mwgg
崅	mqeh
崈	pfim
崉	mijg
崊	mssy
崋	mgag
崌	mndg
崍	msww
崏	mqaj
崐	mjxx
崑	mjxx
崒	mywf
崓	mldg
崕	mdff
崗	mmum
崘	mwga
崙	mwga
崚	mfwt
崜	mtgf
崝	mgeg
崟	mqf
崠	msjg
崡	mbib
崢	mevh
崣	mtvf
崥	mrtf
崨	mgvh
崪	mywf
崫	mnbm
崬	msjf
崯	mqg
崰	mvlg
崱	mmjj
崲	mrgg
崳	mwgj
崵	mjgr
崶	mfff
崷	musg
崸	mdmy
崹	myuh
崺	mytb
崻	mtff
崼	mjgh
崿	mkkn
嵀	msyg
嵁	mdwn
嵂	mtvg
嵃	mute
嵄	mugd
嵅	mdgk
嵆	tdnm
嵈	megc
嵉	myps
嵍	cnhm
嵎	mjmy
嵏	mrbt
嵐	mwtj
嵑	mjqn
嵒	kkkm
嵓	mkkk
嵔	mlge
嵕	mrbt
嵖	msjg
嵗	mdgh
嵙	mtuf
嵚	mqqw
嵜	mukh
嵞	wgsm
嵟	mdwy
嵠	mexd
嵡	mwcn
嵢	mwyk
嵣	movk
嵤	oopm
嵥	mqgs
嵦	mmgu
嵧	mqyl
嵨	mqoy
嵪	mymk
嵭	myuy
嵮	mfhw
嵰	muvw
嵱	mpwk
嵲	mths
嵳	muaf
嵵	mjff
嵶	mxuu
嵷	mtwh
嵸	mtwh
嵹	mxkj
嵺	mnwe
嵻	movi
嵼	mutg
嵽	maqh
嵾	mcce
嵿	msdm
嶀	mffn
嶁	mlvg
嶃	mlrh
嶄	mlrj
嶅	gqtm
嶆	mgmj
嶇	makk
嶈	muqf
嶉	mkwy
嶊	mrwy
嶋	mqoy
嶌	mqou
嶍	mnrg
嶎	mnff
嶏	mdsn
嶐	mbtg
嶑	mqke
嶒	mulj
嶓	mtol
嶔	mqqw
嶕	mwyo
嶖	mwgn
嶗	mooe
嶘	msaa
嶚	mdui
嶛	mdui
嶜	maqj
嶞	bdam
嶟	musf
嶠	mtdk
嶡	mduw
嶢	mffq
嶣	mwyo
嶤	mffq
嶥	mduw
嶦	mqdy
嶧	mlff
嶨	errm
嶩	mmae
嶪	mouf
嶫	mouf
嶬	mugy
嶭	mtnu
嶮	mwgw
嶯	mkby
嶰	mqeg
嶱	majn
嶲	mwyn
嶳	mgef
嶴	tmom
嶵	mlhd
嶶	mtmt
嶸	moos
嶹	mfnf
嶺	mwym
嶻	mfay
嶼	megw
嶽	mqtd
嶾	mean
嶿	mfdj
巀	miwa
巁	mday
巂	mwyk
巃	mued
巄	mued
巆	mook
巇	mhga
巈	mafo
巉	mqky
巊	mmmv
巋	mtnh
巌	midt
巎	mdht
巏	maky
巐	myma
巑	mtfm
巒	yxxm
巓	mxhm
巔	mfhm
巕	mutv
巖	mkkt
巗	mkkt
巘	mhgd
巙	mutt
巚	mhgd
巜	bnn
巟	ynkb
巠	gvaf
巣	ijsu
巤	vlrn
巪	annb
巬	awgu
巭	aegu
巰	gvak
巵	rgcv
巶	vknn
巸	ahkn
巹	bign
巺	nngw
巻	ugnb
巼	ckxb
巿	gmhk
帀	gmhk
帄	mhsh
帇	vmhk
帉	mhwv
帊	mhcn
帋	qamh
帍	ynmh
帎	mhpq
帒	wayh
帓	mhgs
帗	mhdy
帞	mhdj
帟	yomh
帠	emhj
帡	mhua
帢	mhwk
帣	ugmh
帤	vkmh
帥	tnmh
帨	mhuq
帩	mhie
帪	mhde
師	tngh
帬	vtkh
帯	gkgh
帰	ytvh
帲	mhtf
帳	mhde
帴	mhaa
帵	mhpb
帶	aqph
帹	mhuv
帺	mhdw
帾	mhfj
帿	mhwd
幀	mhhm
幁	mhdm
幃	mhng
幆	mhjn
幇	fffh
幈	mhna
幉	mhas
幊	mham
幋	tuwh
幍	mhee
幎	mhpu
幏	mhpe
幐	eugh
幑	tmtt
幒	mhtn
幓	mhce
幖	mhsi
幗	mhlg
幘	mhgm
幙	mhad
幚	dtbh
幜	mhji
幝	mhkf
幟	mhyj
幠	mhto
幣	itmh
幤	imkh
幥	mhir
幦	nkuh
幧	mhks
幨	mhqy
幩	mhfm
幪	mhae
幫	fffh
幬	mhff
幭	mhaw
幮	mhof
幯	mhtb
幰	mhpn
幱	mhul
幵	gdfh
幷	tgdf
幹	fjwf
幾	xxaw
庁	osk
庂	owi
広	oci
庅	otci
庈	owyn
庉	ogbn
庌	oaht
庍	ork
庎	owjk
庒	ofyi
庘	olk
庛	ohxv
庝	otui
庡	oyei
庢	ogcf
庣	oqii
庤	offi
庨	oftb
庩	owgs
庪	orfc
庫	olk
庬	odny
庮	osgd
庯	osi
庰	ouak
庱	ofwt
庲	osww
庴	oajd
庺	owcs
庻	oaww
庼	oxdm
庽	ojmy
庿	oald
廀	opoc
廁	omjk
廂	oshd
廃	owfq
廄	ovwc
廅	ofcl
廆	orqc
廇	oqyl
廈	odht
廋	oehc
廌	ogno
廍	oukb
廎	oxdm
廏	orxc
廐	orxq
廔	olvd
廕	obwc
廗	oaqh
廘	ooxx
廙	olaw
廚	ofkf
廜	onfj
廝	odwr
廞	oqqw
廟	ofje
廠	oimt
廡	otgo
廢	owxc
廣	oamw
廤	olkx
廥	owgj
廦	onku
廧	ofwk
廩	oylt
廫	oene
廬	ohll
廭	otgm
廮	ommv
廯	oqou
廰	obfn
廱	ovky
廲	ogmx
廳	obgn
廵	vpv
廸	mpd
廹	rpd
廻	lkpd
廼	spd
廽	ljfp
弅	wvaj
弆	fcaj
弇	wgka
弉	ufaj
弌	agyi
弍	afyi
弎	adyi
弐	gafy
弒	rsyy
弔	xhk
弖	xgf
弙	xgfh
弚	uxhj
弜	xxn
弝	xcn
弞	xqwy
弡	xang
弢	xbhc
弣	xwfy
弤	xqay
弨	xvkg
弫	xahh
弬	xahh
弮	ugxb
弰	xieg
弲	xkeg
弳	xgva
弴	xybg
張	xdey
弶	xyiy
強	xcjy
弸	xeeg
弻	xglx
弽	xans
弾	xijf
弿	pawx
彁	xskk
彂	oxtd
彃	xjag
彄	xakk
彅	xuev
彆	itxb
彇	xvfj
彈	xkkf
彉	xamw
彊	xglg
彋	xlge
彌	xgwr
彍	xoaw
彎	yxxx
彏	xhhc
彑	xnng
彔	xiu
彙	xpjs
彚	vpjs
彛	vowa
彜	xowa
彞	voxa
彟	vfac
彠	vakc
彣	yee
彥	yder
彧	akgr
彨	gmye
彫	mfke
彮	pwwe
彯	sfie
彲	gmye
彴	tqyy
彵	tbn
彶	tbyy
彸	twcy
彺	tgg
彽	tqay
彾	twyc
彿	txjh
徃	ttgg
徆	tsg
徍	tffg
徎	tkgg
徏	thht
徑	tgva
従	tuhy
徔	tapy
徖	tpfi
徚	tslg
徛	tdsk
徝	tfhg
從	twwh
徟	tmfk
徠	tsww
徢	tgvh
徣	tajg
徤	tvgp
徥	tjgh
徦	tnhc
徧	tyna
復	ttjt
徫	tnkg
徬	tyuy
徯	texd
徰	tghh
徱	tsfi
徲	tnig
徳	tfln
徴	tmgt
徶	tity
徸	tujf
徹	tyct
徺	tffq
徻	twgj
徾	tmyt
徿	tued
忀	tyke
忁	tjbi
忂	thhy
忇	net
忈	fnu
忊	nsh
忋	nnn
忎	tfnu
忓	nfh
忔	ntnn
忕	ndy
忚	nbn
忛	nwyy
応	oni
忞	ynu
忟	nyy
忢	gnu
忣	nbyy
忥	rni
忦	nwjh
忨	nfqn
忩	wcnu
忬	ncnh
忯	nqan
忰	nvfh
忲	ndyy
忳	ngbn
忴	nwyn
忶	nfcy
忷	nrbh
忹	ngg
忺	nqwy
忼	nywn
怇	nang
怈	nann
怉	nqnn
怋	nnan
怌	ndhg
怐	nqkg
怑	nugh
怓	nvcy
怗	nhkg
怘	dnu
怚	negg
怞	nmg
怟	nqay
怢	ntgy
怣	tgnu
怤	wfnu
怬	nlg
怭	nntt
怮	nxet
怰	nyxy
怱	qryn
怲	ngmw
怳	nkqn
怴	nann
怶	nby
怷	fqyn
怸	synu
怹	wbnu
怺	nyni
怽	nfy
怾	nkwy
恀	nqqy
恄	nfkg
恅	nftx
恆	nghg
恇	nagg
恈	nctg
恉	nxjg
恊	neee
恌	nqiy
恎	ngcf
恏	vbnu
恑	nqdb
恓	nsg
恔	nury
恖	tlrn
恗	ndfn
恘	nwsy
恛	nlkg
恜	naay
恞	ngxw
恟	nqrb
恠	ndhf
恡	nrdc
恥	bny
恦	ntmk
恮	nwgg
恱	nwcq
恲	nuah
恴	yjnu
恵	gmnu
恷	wsnu
恾	nayn
悀	nceh
悁	nkeg
悂	nxxf
悅	nwkq
悆	wgsn
悇	nwgs
悈	naah
悊	rrnu
悋	nykg
悎	ntfk
悏	ndww
悐	qton
悑	nsy
悓	nhqn
悕	nrdh
悗	nqkq
悘	atdn
悙	nybh
悜	nkgg
悞	nknd
悡	tjnu
悢	nyvy
悤	tlqn
悥	ynu
悧	ntjh
悩	nirb
悪	gkjn
悮	nkgd
悰	npfi
悳	fhnn
悵	ndey
悶	uni
悷	nynd
悹	pnnu
悺	npng
悽	ngvv
悾	npwa
悿	ngdn
惀	nwga
惁	srnu
惂	nqeg
惃	njxx
惄	hicn
惇	nybg
惈	njsy
惉	ihkn
惌	pqbn
惍	nqg
惎	dwnu
惏	nssy
惐	nakg
惒	tknu
惓	nugb
惔	nooy
惖	jqrn
惗	nwyn
惙	nccc
惛	nqaj
惞	nrqw
惡	gfgn
惢	nnnu
惣	cqrn
惤	nxyx
惥	ewnu
惪	fhnu
惱	nvtr
惲	nplh
惵	nans
惷	dwjn
惸	nqjb
惻	nmjh
惼	nyna
惽	nnaj
惾	nrbt
惿	njgh
愂	fpbn
愃	npgg
愄	nlge
愅	nafh
愇	nnkg
愊	ngkl
愋	negc
愌	nqmd
愐	ndlf
愑	ncee
愒	njqn
愓	njgr
愔	nujg
愖	ndwn
愗	cnhn
愘	nptk
愙	ptkn
愛	epnt
愜	nadw
愝	najv
愞	ndmd
愡	nqrn
愢	nlny
愥	namd
愨	fpgn
愩	namy
愪	nkmy
愬	ubtn
愭	nftj
愮	netb
愯	nwyc
愰	njiq
愱	nutd
愲	nmeg
愳	hhnu
愴	nwyk
愵	nxuu
愶	neee
愷	nmgu
愸	swwn
愹	npwk
愺	najh
愻	btxn
愼	nxhw
愽	nsfy
愾	nroy
慀	nexd
慁	lgen
慂	icen
慃	nwcn
慄	nssy
慅	ncyj
慆	neeg
慇	rvnn
慉	nyxl
態	cexn
慍	nlwl
慏	npju
慐	amnu
慒	ngmj
慓	nsfi
慔	najd
慖	nlag
慗	sktn
慘	ncce
慙	lrnu
慚	nlrh
慛	nmwy
慜	txtn
慞	nujh
慟	ntge
慠	ngqt
慡	ndrr
慣	nxmy
慤	fpwn
慥	ntfp
慦	giyn
慩	nlpy
慪	nakk
慫	twwn
慬	nakg
慭	gusn
慮	hlni
慯	ntjr
慱	ngjf
慲	namy
慳	nahf
慴	nnrg
慶	onnt
慸	aqpn
慹	fufn
慺	nlvg
慻	nugh
慼	dhin
慽	ndhi
慾	wwkn
慿	ucan
憀	nnwe
憁	ntln
憂	dept
憃	dwen
憄	tfhn
憅	tgjn
憆	nipf
憇	tdfn
憈	nhog
憉	nfke
憊	watn
憌	qqun
憍	ntdk
憏	nwfi
憐	noqg
憑	ucon
憒	nkhm
憓	ngjn
憕	nwgu
憖	swwn
憗	swwn
憘	nfkk
憙	fkun
憚	nkkf
憛	nsjh
憜	nbde
憞	nybt
憟	nsoy
憠	dubn
憡	ntsm
憢	nffq
憣	ntol
憤	nfam
憥	oopn
憦	nooe
憪	nueg
憫	nuyy
憭	ndui
憮	ntgo
憯	naqj
憰	ncnk
憱	nyiy
憲	pgln
憳	nvaf
憴	nxg
憵	nkun
憶	nujn
憸	nwgw
憹	nmae
憺	nqdy
憻	nylg
憼	aqkn
憽	naqn
憿	nryt
懀	nwgj
懁	nlge
懃	akgn
懄	nake
懅	nhge
懆	nkks
懇	evnu
應	owwn
懌	nlff
懍	nylt
懎	nfwk
懏	nwyn
懐	nyle
懓	nept
懕	djen
懖	qtdn
懗	nfoo
懘	iaqn
懙	negw
懚	nean
懛	nfkf
懜	nalq
懝	nxth
懞	nape
懟	ougn
懠	nyjg
懡	nosc
懢	nahl
懣	iamn
懤	nfnf
懥	nfph
懧	npns
懨	ndjd
懩	nugv
懪	njai
懫	nrrm
懬	oamn
懭	noaw
懮	ndet
懯	sytn
懰	nqyj
懱	nalw
懲	tmgn
懳	ndhn
懴	nfag
懶	nskm
懷	nyle
懸	hitn
懹	nyke
懺	nwwg
懻	nuxw
懼	nhhy
懽	naky
懾	nbbb
戀	yxxn
戁	akgn
戂	nosd
戃	nipo
戄	nhhc
戅	ujan
戇	ujtn
戉	anv
戓	akd
戔	aau
戙	mgka
戜	akgd
戝	may
戞	depa
戠	yuaj
戣	wgda
戦	ijfa
戧	wyva
戨	sksa
戩	gcca
戫	deag
戭	pgma
戯	hoay
戰	kkja
戱	hjna
戲	hgka
戵	hhwa
戶	tne
戸	gnr
戹	ynnv
戺	ynnn
戻	yndi
戼	nagn
扂	ynhk
扄	yntk
扅	ynqq
扆	ynye
扊	ynoo
扏	rvn
扐	ret
払	rcy
扖	rtyy
扗	rfg
扙	rdyy
扚	rqyy
扜	rgfh
扝	rfnn
扞	rfh
扟	rnfh
扠	rcyy
扡	rbn
扢	rtnn
扤	rgqn
扥	rtan
扨	rvyy
扱	rbyy
扲	rwyn
扴	rwjh
扵	rwuy
扷	rtdy
扸	rthn
扺	rqan
扻	rqwy
扽	rgbn
抁	rcqn
抂	rgg
抃	ryhy
抅	rqcy
抆	ryy
抇	rjg
抈	reg
抋	rny
抌	rpqn
抍	rtah
抎	rfcy
抏	rfqn
抐	rmwy
抔	rdhy
抙	rrh
抜	rdcy
抝	rxnn
択	rnyy
抣	rqug
抦	rgmw
抧	rkwy
抩	rmfg
抪	rdmh
抭	rpwn
抮	rwet
抯	regg
抰	rmdy
抲	rskg
抳	rnxn
抴	rann
抶	rtgy
抷	rdhg
抸	rtpy
抺	rfy
抾	rfcy
拀	rkqn
拁	rekg
拃	rthf
拋	rdne
拏	vcrj
拑	rfg
拕	rpxn
拝	rdfh
拞	rrg
拠	rtwn
拡	rocy
拤	rhhy
拪	rsg
拫	rvy
拰	rwtf
拲	awrj
拵	rdhb
拸	rqqy
拹	reee
拺	rsmn
拻	rdoy
挀	rrey
挃	rgcf
挄	rigq
挅	rbsy
挆	rwsy
挊	rhgh
挋	rahh
挌	rtkg
挍	rury
挏	rmgk
挐	vkrj
挒	rgqj
挓	rpta
挔	ryey
挕	rbg
挗	rgxw
挘	rite
挙	igwr
挜	rgog
挦	rvfy
挧	rng
挩	rwkq
挬	rfpb
挭	rgjr
挮	ruxt
挰	rkgg
挱	riit
挳	rgva
挴	rtxy
挵	rgah
挶	rnnk
挷	rdtb
挸	rhqn
挻	rthp
挼	revg
挾	rdww
挿	rtgh
捀	rtdh
捁	rtfk
捄	rgiy
捇	rfoy
捈	rwgs
捊	rebg
捑	rjny
捒	rskg
捓	rahb
捔	rqeh
捖	rpfq
捗	rhht
捘	rcwt
捙	rlh
捚	rjfg
捛	rkkg
捜	rjhc
捝	rukq
捠	rrwy
捤	rnen
捥	rpqb
捦	rqg
捨	rwfk
捪	rqaj
捫	rug
捬	rowf
捯	rgcj
捰	rjsy
捲	rugb
捳	rrmh
捴	rwcn
捵	rmaw
捸	rviy
捹	rdfa
捼	rtvg
捽	rywf
捾	rpng
捿	rgvv
掁	rdey
掃	rvph
掄	rwga
掅	rgeg
掆	rmum
掋	roqy
掍	rjxx
掑	rdwy
掓	rhic
掔	ahnr
掕	rfwt
掗	rgfg
掙	revh
掚	rgmy
掛	rffh
掜	reqn
掝	rakg
掞	rooy
掟	rpgh
採	resy
掤	reeg
掦	rjqr
掫	rbcy
掯	rheg
掱	rrrj
掲	rjqx
掵	rwgb
掶	rovw
掹	rblg
掻	rcjy
掽	ruog
掿	radk
揀	rslg
揁	rhmy
揂	rusg
揃	ruej
揅	dgar
揇	rfmf
揈	rqyg
揊	rgkl
揋	rlge
揌	rlny
揑	reag
揓	rytb
揔	rqrn
揕	rdwn
揗	rrfh
揘	rrgg
揙	ryna
揚	rjgr
換	rqmd
揜	rwga
揝	rthj
揟	rnhe
揢	rptk
揤	rvbh
揥	ryuh
揦	rskj
揧	skjr
揨	ryps
揫	torj
揬	rpwd
揮	rplh
揯	rngg
揰	rtgf
揱	iejr
揳	rdhd
揵	rvgp
揷	rtgh
揹	ruxe
揺	refb
揻	rdgv
揼	rdiy
揾	rjlg
搃	rukn
搄	rngg
搆	ramf
搇	rwye
搈	rpwk
搉	rpwy
搊	rqbt
損	rkmy
搎	rbti
搑	rabg
搒	ryuy
搕	rfcl
搖	rqtb
搗	rqmh
搘	rftj
搙	rdff
搚	reee
搝	rthd
搟	rlfh
搢	rgoj
搣	rdgo
搤	ruwl
搥	rtnp
搧	rynn
搨	rjng
搩	rqgs
搫	tuwr
搮	rssy
搯	reeg
搰	rmeg
搱	rnuh
搲	rpwy
搳	rpdk
搵	rlwl
搶	rwyk
搷	rfhw
搸	rdwt
搹	rgkh
搻	wgkr
搼	rugr
搾	rpwf
摀	rqoy
摂	rbiy
摃	ramy
摉	rpwq
摋	rrsc
摌	rutg
摍	rpwj
摎	rnwe
摏	rdwe
摐	rtwh
摑	rlag
摓	rtdp
摕	raqh
摖	rwfi
摗	rskw
摙	rlpy
摚	ripf
摛	ryrc
摜	rxmy
摝	roxx
摟	rlvg
摠	rtln
摡	rvaq
摢	rhtf
摣	rheg
摤	rdrr
摥	rtjr
摦	rdfy
摨	rnig
摪	ruqf
摫	rghq
摬	rujq
摮	gqtr
摯	fufr
摰	fwfr
摱	rjlc
摲	rlrh
摳	rakk
摴	rffn
摵	rdhi
摶	rgjf
摷	rvjs
摻	rcce
摼	rahf
摽	rsfi
摾	rxkj
摿	rwuj
撀	fnwr
撁	ryxg
撃	lwcr
撆	itrj
撈	rooe
撉	ybtr
撊	rueg
撋	rugg
撌	rkhm
撍	raqj
撎	rfpu
撏	rvaf
撐	ript
撓	rffq
撔	rjyi
撗	ramw
撘	rtwk
撚	rqdo
撛	roqg
撜	rwgu
撝	reto
撟	rtdk
撠	rfja
撡	rccn
撢	rsjh
撣	rkkf
撥	rwxc
撦	rdfj
撧	rxqc
撨	rwyo
撪	rcdl
撫	rtgo
撯	ruhg
撱	rbde
撲	roug
撳	rqqw
撴	rybt
撶	ragg
撹	ripq
撻	rfup
撽	rryt
撾	rmnp
撿	rwgw
擁	ryxy
擃	rmae
擄	rhle
擆	rafj
擇	rlff
擈	rouf
擉	rlqj
擊	lbwr
擋	ripl
擌	rtdw
擏	raqt
擑	rkby
擓	raiy
擔	rqdy
擕	rwyn
擖	rajn
擙	rtmd
據	rhge
擛	raas
擜	rfmd
擝	rjel
擟	rgwr
擠	ryjg
擡	rfkf
擣	rfnf
擥	ahnr
擧	egnr
擨	rrhw
擩	rfdj
擪	djer
擫	rdjd
擬	rxth
擭	rawc
擮	rfay
擯	rpgm
擰	rpns
擱	rutk
擲	rusb
擳	rtvb
擴	roaw
擵	rosr
擶	rtuj
擷	rfkm
擸	rvln
擹	rakw
擺	rlcx
擻	rlvt
擼	rqoj
擽	rrxs
擾	rdet
擿	ryup
攁	rugv
攂	rlll
攃	rawi
攄	rhln
攅	rggm
攆	rggl
攇	rpdn
攈	roxt
攊	rdth
攋	rskm
攌	rlle
攍	ryey
攎	rhll
攏	rued
攐	rpae
攑	regg
攓	rpah
攔	rusl
攕	rwwg
攖	rmmv
攗	roxo
攙	rqky
攚	rook
攛	rpwn
攜	rmwk
攝	rbbb
攞	rlxy
攟	roxt
攠	rosd
攡	ryry
攢	rtfm
攣	yxxr
攤	raky
攦	rgmx
攧	rfhm
攨	rpwy
攩	ripo
攪	rerq
攬	rahq
攭	rxej
攰	fcee
攱	ufcy
攲	dskc
攳	fcvf
攷	gnty
攺	nty
攼	fty
攽	wvty
敀	rty
敁	hkhc
敂	qkty
敃	naty
敄	cnht
敆	wgkc
敇	smty
敊	hihc
敋	tkty
敍	wgsc
敎	rdbt
敐	dfet
敒	wjht
敓	wkqt
敔	gkty
敗	mty
敘	wgst
敚	ukqt
敜	wynt
敟	mawt
敠	cccc
敡	jqrc
敤	jshc
敥	oohc
敧	dskc
敨	ukty
敩	ipbt
敪	ccct
敭	jgqt
敮	tfec
敯	najc
敱	mgkc
敳	mgkt
敵	yumt
敶	bsjt
數	lvty
敹	hptt
敺	akkc
敻	qmwt
敼	fkuc
敽	tdkc
敾	uukt
敿	tdkt
斀	lqjc
斁	lfut
斂	wgkt
斃	itgx
斄	ftdw
斅	errc
斆	errt
斈	ybf
斉	yjf
斊	ybf
斍	yhqb
斎	yjiu
斏	yyvy
斒	yyna
斔	yjew
斕	yusl
斖	yemg
斘	qufh
斚	ccpf
斝	kkpf
斞	ewuf
斠	amff
斢	amwf
斣	lqjf
斦	rrh
斨	urh
斪	qkrh
斬	lrh
斮	ajrh
斱	ftjr
斲	anfr
斳	akgr
斴	oqgr
斵	qyvr
斶	rlqj
斷	xxgr
斸	nilr
斺	ywjh
斻	ytwn
斾	ytmh
斿	ytbg
旀	yciy
旂	ytrh
旇	ytby
旈	yyck
旉	syr
旊	ytgy
旍	ytwc
旐	ytqi
旑	ydsk
旓	ytie
旔	yvgp
旕	ywux
旘	yyuj
旙	ytol
旚	ytsi
旛	yttl
旜	ytyg
旝	ytwj
旞	ytup
旟	ytew
旡	aqv
旣	rxaq
旤	mnmq
旪	jfh
旫	jvt
旲	jdu
旳	jqyy
旴	jgfh
旵	jmj
旸	jnrt
旹	bhgj
旻	jyu
旼	jyy
旽	jgbn
旾	gbnj
旿	jtfh
昁	jgmh
昄	jrcy
昅	jbyy
昇	jtaj
昈	jynt
昉	jyt
昋	gdjf
昍	jjg
昐	jwvt
昑	jwyn
昒	jqrt
昖	jwcy
昗	juu
昘	jyr
昚	dujf
昛	jang
昜	jgqr
昞	jgmw
昡	jyxy
昢	jbmh
昣	jwet
昤	jwyc
昦	jdjj
昩	jgsy
昪	jcaj
昫	jqkg
昬	najf
昮	jaer
昰	jghf
昲	jxjh
昳	jtgy
昷	jlf
昸	jtuy
昹	jyni
昺	jgmw
昻	jabj
昽	jdxy
昿	jocy
晀	jqiy
時	jffy
晄	jigq
晅	jgjg
晆	jffg
晇	jdfn
晈	jury
晉	gccj
晊	jgcf
晍	jmgk
晎	jawy
晐	jynw
晑	jtmk
晘	jjfh
晙	jcwt
晛	jhqn
晜	juxt
晝	vfjg
晞	jrdh
晠	jdnn
晢	rrjf
晣	jrrh
晥	jpfq
晧	jtfk
晩	jqkq
晪	jmaw
晫	jhjh
晬	jywf
晭	jmfk
晱	jooy
晲	jeqn
晳	srjf
晵	yntj
晸	jght
晹	jjqr
晻	jdjn
晼	jpqb
晽	jssy
晿	jjjg
暀	jtyg
暁	jfaq
暃	jhdd
暅	jngg
暆	jytb
暈	jplj
暉	jplh
暊	jdmy
暋	natj
暍	jjqn
暎	jamd
暏	jftj
暐	jnkg
暒	jjtg
暓	cnhj
暔	jfmf
暕	jslg
暘	jjgr
暙	jdwj
暚	jetb
暛	juag
暜	uujf
暞	jths
暟	jmgu
暠	jymk
暡	jwcn
暢	jhjr
暣	jroy
暤	jrdf
暥	jjpv
暦	dssj
暩	jwfi
暪	jamy
暫	lrjf
暬	fwfj
暭	jrif
暯	jajd
暰	jtwh
暱	jaak
暲	jujh
暳	jdhv
暵	jakg
暶	jyth
暷	jgjf
暸	jdui
暺	jkkf
暻	jjyi
暼	itjf
暽	joqg
暿	jfkk
曀	jfpu
曁	rxag
曂	jamw
曃	jvip
曄	jagg
曅	jagg
曆	dttj
曇	jffc
曈	jujf
曉	jffq
曊	jxjm
曋	jsjh
曌	jepa
曍	jthf
曎	jlff
曏	jxtb
曐	jjjg
曑	jjje
曒	jryt
曓	jbmf
曔	jaqt
曕	jqdy
曖	jept
曗	jouf
曘	jfdj
曚	jape
曞	jday
曟	jjje
曠	joaw
曡	jjjg
曢	jpdi
曣	jako
曤	jfwy
曥	jhll
曧	jgkj
曨	jued
曪	jlxy
曫	yxxj
曬	jgmx
曭	jipo
曮	jkkt
曯	jnij
曱	mfk
曵	jnty
曶	qrjf
書	vfjf
曺	gmjf
曻	jqgj
曽	uljf
朁	aqaj
朂	jber
會	wglj
朄	jhsl
朅	fcjn
朆	uljr
朇	wglf
朌	ewvt
朎	ewyc
朏	ebmh
朑	eann
朒	emww
朓	eqiy
朖	eyvy
朘	ecwt
朙	lwme
朚	ynje
朜	eybg
朞	dwef
朠	eamd
朡	erbt
朢	ahng
朣	eujf
朤	eeee
朥	eooe
朧	eued
朩	sghy
朮	fqyi
朰	snb
朲	swy
朳	swy
朶	bsu
朷	svt
朸	set
朹	svn
朻	snhh
朼	sxn
朾	ssh
朿	smv
杁	styy
杄	stfh
杅	sgfh
杇	sfnn
杊	skh
杋	swyy
杍	sbg
杒	svyy
杔	stan
杕	sdy
杗	ynsu
杘	nsi
杙	sayy
杚	stnn
杛	sxn
杝	sbn
杢	saf
杣	smh
杤	sgqt
杦	sqyy
杧	synn
杫	shg
杬	sfqn
杮	sgmh
東	sjd
杴	sqwy
杶	sgbn
杸	swcy
杹	swxn
杺	sny
杻	snhg
杽	srh
枀	wcsu
枂	seg
枃	squg
枅	sgah
枆	sen
枈	xxsu
枊	sqbh
枌	swvt
枍	swgn
枎	sgy
枏	smfg
枑	sgxg
枒	saht
枓	sufh
枔	swyn
枖	stdy
枙	sdbn
枛	srhy
枟	sfcy
枠	svfh
枡	stah
枤	sdy
枦	synt
枩	swcu
枬	smyg
枮	shkg
枱	sckg
枲	cksu
枴	skvt
枹	sqnn
枺	sgsy
枻	sann
枼	ansu
枽	fasu
枾	sfjg
枿	sfah
柀	sby
柂	stbn
柅	snxn
柆	sug
柇	sty
柈	sugh
柉	stpy
柊	stuy
柋	ways
柌	sngk
柍	smdy
柎	swfy
柕	scnt
柖	svkg
柗	swkg
柛	sjhh
柟	smfg
柡	sfiy
柣	stgy
柤	segg
柦	sjgg
柧	srcy
柨	sdmh
柪	sxet
柫	sxjh
柭	sdcy
柮	sbmh
柲	sntt
柵	smah
柶	slg
柷	skqn
柸	sdhg
柹	stnt
柺	sket
査	segf
柼	spwy
柾	sghg
栁	sqbh
栂	sxy
栃	srgq
栄	ipsu
栆	gkhu
栍	stgg
栐	syni
栒	sqjg
栔	dhvs
栕	sahh
栘	sqqy
栙	stgh
栚	sudy
栛	seee
栜	ssmn
栞	gdfs
栟	suah
栠	wtfs
栢	sdjg
栣	swtf
栤	suiy
栥	uqws
栦	syth
栧	sjnt
栨	suqw
栫	sdhb
栬	sqcn
栭	sdmj
栮	sbg
栯	sdeg
栰	sway
栱	sawy
栴	stmy
栵	sgqj
栶	sldy
栺	sxjg
栻	saay
栿	swdy
桇	vksu
桋	sgxw
桍	sdfn
桏	sabh
桒	fasu
桖	stlg
桗	sbsy
桘	stng
桙	sctg
桚	svqy
桛	shgh
桜	sivg
桝	sqgh
桞	sqbh
桟	sfay
桪	svfy
桬	iits
桭	sdfe
桮	sdhk
桯	skgg
桰	sqak
桱	sgva
桲	sfpb
桳	scdf
桵	sevg
桸	srdh
桹	syvy
桺	sgjn
桻	stdh
桼	swiu
桽	swwf
桾	svtk
桿	sjfh
梀	sskg
梂	sgiy
梄	ssgg
梇	sgah
梈	sybh
梉	sufg
梊	rrsu
梋	skeg
梌	swgs
梍	sran
梎	srxn
梐	sxxf
梑	sqto
梒	swyk
梔	srgc
梕	svyn
梖	smy
梘	shqn
梙	skkh
梚	sqkq
梛	sngb
梜	sdww
條	whts
梞	snny
梟	qsu
梠	skkg
梡	spfq
梣	smwn
梤	smwv
梥	pwcs
梩	sjfg
梪	sgku
梫	svpc
梬	smgn
梮	snnk
梱	slsy
梲	swkq
梴	sthp
梶	snen
梷	hkcs
梸	stjh
梹	srwy
梺	ssgh
梻	swxj
梼	sdtf
梽	sfny
梾	sgus
梿	slpy
棁	sukq
棃	tqts
棄	ycas
棅	stvg
棆	swga
棇	swcn
棈	sgeg
棊	dwsu
棌	sesy
棎	spws
棏	sjgf
棐	hdhs
棑	shdd
棓	sukg
棔	sqaj
棖	sdey
棗	smsm
棙	synd
棛	syce
棜	sywu
棝	sldg
棞	slty
棟	ssjg
棡	smum
棢	smun
棤	sajg
棥	srrs
棦	sqvh
棧	saay
棨	ynts
棩	sjgg
棪	sooy
棫	sakg
棬	sugb
棭	sywy
棯	swyn
棲	sgvv
棳	sccc
棴	sebc
棶	ssww
棷	sbcy
棸	bcsu
棻	awvs
棽	sswn
棾	sspw
棿	seqn
椀	spqb
椂	sviy
椃	shwn
椄	suvg
椆	smfk
椇	shwy
椈	sqoy
椉	yqgs
椊	sywf
椌	spwa
椏	sgfg
椑	srtf
椓	sgey
椔	svlg
椕	swvs
椖	syny
椗	spgh
椘	sspu
椙	sjjg
椚	sug
椛	sawx
検	swgw
椝	gmqs
椞	srsu
椡	sgcj
椢	slgy
椣	smaw
椥	stdk
椦	suge
椧	swgb
椨	sowf
椩	sovw
椪	suog
椫	sujf
椬	speg
椮	scde
椯	smdj
椱	stjt
椲	snkg
椳	slge
椵	snhc
椶	srbt
椷	sdgk
椸	sytb
椺	swks
椻	sajv
椼	stis
椾	suej
楀	stky
楁	sptk
楃	sngf
楄	syna
楅	sgkl
楆	ssvg
楇	smnk
楈	snhe
楉	sadk
楊	sjgr
楋	sskj
楌	sute
楍	skkk
楎	splh
楏	sdff
楐	slwj
楑	swgd
楒	slny
楓	swtj
楕	sdae
楖	svbh
楘	cnhs
楙	scns
楛	sadg
楜	sdeg
楟	syps
楡	swgb
楢	susg
楤	sqrn
楥	segc
楧	samd
楨	shmy
楩	swgr
楪	sans
楬	sjqn
業	oufu
楯	srfh
楰	sewy
楲	sdgv
楳	sfsy
楴	syuh
極	sbkg
楶	uqws
楺	scns
楻	srgg
楽	risu
楾	sriy
楿	stjg
榁	spgf
榃	sslf
榅	sjlg
榊	spyh
榋	svvv
榌	snuh
榎	sdht
榏	suwl
榐	snae
榑	ssfy
榒	sxuu
榓	sntl
榖	fpgc
榗	sgoj
榙	sawk
榚	sugo
榝	srsc
榞	sdri
榟	spuh
榠	spju
榡	sgxi
榢	spge
榣	setb
榤	sqgs
榥	sjiq
榦	fjws
榩	shyy
榪	scoy
榬	sfke
榮	oops
榯	sjff
榰	sftj
榲	slwl
榳	sotp
榵	sabg
榶	sovk
榸	sfjf
榹	srhw
榺	eugs
榼	sfcl
榽	sexd
榾	smeg
榿	smgu
槀	ymks
槂	sbti
槃	tuws
槄	seeg
槅	sgkh
槆	saqj
槇	sxhw
槈	sdff
槉	sutd
構	samf
槍	swyk
槏	suvw
槑	ksks
槒	syxl
槓	samy
槕	shjs
槖	fpds
槗	sdkk
様	sugi
槙	sfhw
槚	ssmy
槜	swyb
槝	sqmh
槞	sujn
槡	sccs
槢	snrg
槣	spdk
槤	slpy
槥	sdhv
槦	sovh
槧	lrsu
槨	sybb
槩	rxas
槪	srxq
槫	sgjf
槬	sdfy
槮	scce
槯	smwy
槰	stdp
槱	ssgo
槳	uqfs
槴	sync
槵	skkn
槶	slag
槷	fwfs
槸	sfwy
槹	srif
槺	sovi
槻	sghq
槼	ghqs
槾	sjlc
樀	syud
樁	sdwe
樂	rxxs
樃	syve
樄	sbsj
樅	stwh
樆	syrc
樇	swhe
樈	sujq
樉	sdrr
樋	scep
樌	sxmy
樍	sgmy
樎	spwj
樏	slxi
樐	shlo
樑	sivs
樒	spnm
樓	slvg
樔	svjs
樕	sskw
樖	wgkk
標	ssfi
樚	soxx
樛	snwe
樜	soao
樝	sheg
樞	sakk
樠	samy
樢	sqoy
樣	sugi
樤	swhs
樥	sath
樦	styg
樧	srsc
権	stgy
樫	sahf
樬	stln
樭	sdwf
樮	ssoy
樰	sfvg
樲	safy
樳	svaf
樴	syuj
樶	sjbc
樷	ssbc
樸	soug
樹	sfkf
樺	sagg
樻	skhm
樼	snbb
樿	skkf
橀	sycl
橁	stqj
橂	susd
橃	swxc
橅	stgo
橆	tgls
橈	sffq
橉	soqg
橊	sgjl
橋	stdk
橌	sueg
橍	sugg
橎	stol
橏	suuk
橑	sdui
橒	sffc
橓	sepg
橔	sybt
橕	sipt
橖	sips
橗	saje
橚	svfj
橜	dubs
橝	ssjh
橞	sgjn
機	sxxw
橠	syqe
橢	sbde
橣	spne
橤	nnns
橦	sujf
橧	sulj
橨	sfam
橩	soow
橪	sqdo
橫	sagw
橬	saqj
橭	sduh
橮	sqym
橯	sooe
橰	sthf
橲	sfkk
橳	seue
橴	shxi
橵	saet
橶	sfja
橷	sruq
橸	sjjj
橺	sujg
橻	snhg
橽	sfup
橾	skks
橿	sglg
檁	sylt
檂	smae
檃	beas
檅	shdh
檆	sook
檇	swyn
檈	slge
檉	sbkg
檊	sfjf
檋	sawl
檌	slhd
檍	sujn
檏	souf
檒	sswj
檓	seac
檔	sipl
檕	lbws
檖	suep
檘	snku
檙	shnn
檚	sssh
檛	smnp
檜	swgj
檝	skby
檞	sqeg
檟	ssmy
檡	slff
檢	swgw
檣	sfwk
檤	sutp
檥	sugy
檦	ssfj
檧	saqn
檨	sugw
檪	sris
檭	sqvy
檮	sfnf
檯	sfkf
檰	sxrh
檱	stdw
檲	slgf
檳	spgm
檴	sawc
檵	sxxn
檶	sdak
檷	sgwr
檸	spns
檹	sytk
檺	sype
檻	sahl
檼	sean
檽	sfdj
檾	oops
檿	djes
櫀	sdwi
櫁	spnj
櫂	snwy
櫃	sakm
櫄	stgo
櫅	syjg
櫆	srqf
櫇	sbdm
櫈	swgw
櫉	sdff
櫊	sutk
櫋	sthy
櫌	sdet
櫍	srrm
櫎	soaw
櫏	ssdp
櫐	llls
櫑	slll
櫒	sawi
櫓	sqoj
櫔	sday
櫕	sggm
櫖	shln
櫗	salw
櫘	sdhn
櫙	saak
櫚	sukk
櫛	stvb
櫜	gkhs
櫝	sflm
櫞	sxxe
櫟	srxs
櫠	sowc
櫡	stfj
櫢	slvt
櫣	salp
櫤	stuj
櫥	soff
櫦	sont
櫧	syfj
櫨	shll
櫩	suqe
櫪	sdth
櫫	gefs
櫬	susq
櫭	svag
櫮	sgkk
櫯	sqot
櫰	syle
櫱	btts
櫲	scne
櫳	sued
櫴	sskm
櫵	sawo
櫶	spdn
櫷	stxg
櫸	segg
櫹	savj
櫺	sfkk
櫻	smmv
櫼	swwg
櫽	beas
櫾	seti
櫿	sook
欀	syke
欁	smas
欂	saif
欃	sqky
欄	susl
欅	segr
欆	swyc
欇	sbbb
欈	smwk
欉	souc
權	saky
欋	shhy
欌	saah
欍	sawe
欎	srrf
欏	slxy
欐	sgmx
欑	stfm
欒	yxxs
欓	sipo
欔	shhc
欕	skkt
欖	sahq
欗	saul
欘	snij
欙	slli
欚	sxej
欛	sfae
欜	sgke
欝	srrf
欞	sfkw
欟	sakq
欥	jqwy
欦	wynw
欨	qkqw
欩	vkqw
欪	bmqw
欫	tghw
欬	yntw
欭	ldqw
欮	ubtw
欯	fkqw
欰	tlqw
欱	wgkw
欳	hmaw
欴	yvqw
欵	xtdw
欶	skqw
欸	ctdw
欻	ooqw
欼	cccw
欽	qqwy
欿	qeqw
歀	sfiw
歁	dwnw
歂	mdmw
歄	mnmw
歅	sfqw
歈	wgew
歊	ymkw
歋	rhww
歍	qoqw
歎	akgw
歏	akgw
歐	akkw
歑	htuw
歒	yumw
歓	tgww
歔	hoqw
歕	famw
歖	fkuw
歗	vfjw
歘	ooow
歚	uukw
歛	wgkw
歜	lqjw
歝	lfuw
歞	jxxw
歟	egnw
歠	cccw
歡	akkw
歨	hhu
歩	hitr
歫	hang
歬	htuu
歭	hffy
歮	hhhf
歯	hobj
歰	vyvh
歱	htgf
歲	hdgh
歳	hdgi
歴	dssh
歵	hgmy
歶	hxjy
歷	dtth
歸	tnhh
歺	hqu
歽	gqrh
歾	gqqr
歿	gqqc
殀	gqtd
殅	gqtg
殈	gqtl
殌	gqga
殎	gqdw
殏	gqgy
殐	gqsk
殑	gqdq
殔	gqvi
殕	gquk
殗	gqdn
殘	gqaa
殙	gqqj
殜	gqas
殝	gqdt
殞	gqkm
殟	gqjl
殠	gqtd
殢	gqah
殣	gqag
殤	gqtr
殥	gqpw
殦	gqqo
殧	gqyy
殨	gqkm
殩	gqho
殫	gqkf
殬	gqlf
殭	gqgg
殮	gqww
殯	gqpm
殰	gqfm
殱	gqfg
殲	gqwg
殶	ygwc
殸	fnwc
殹	atdc
殺	rswc
殻	fpwc
殼	fpgc
殽	rdec
殾	ftjc
毀	efwc
毃	ymkc
毄	lkwc
毆	akkc
毇	eowc
毈	qytc
毉	atdw
毊	fnwk
毌	xnnh
毎	tnnf
毐	fnnd
毑	xbn
毘	lxxb
毚	qkxy
毜	eii
毝	eee
毞	xxeb
毟	iteb
毠	ekeb
毢	esd
毣	neb
毤	wcqe
毥	eqjd
毦	ben
毧	eade
毨	etfq
毩	eoi
毬	egiy
毭	gkue
毮	rite
毰	eukd
毱	eqoi
毲	ccce
毴	ehdd
毶	ecde
毷	jhen
毸	elni
毺	ewgj
毻	daee
毼	jqwe
毾	jnen
毿	ccce
氀	lven
氁	eajd
氂	ftde
氃	ujfe
氄	cnhe
氈	ylke
氉	kkke
氊	eylg
氋	apfe
氌	eqoj
氎	llle
氒	qafj
気	rri
氜	rjd
氝	rmwi
氞	rgmw
氠	rjhk
氣	roi
氥	rsd
氫	rgva
氬	rgfg
氭	rsjd
氱	rjgr
氳	rlwl
氶	bii
氷	yii
氹	nii
氺	ihyy
氻	iet
氼	iwu
氾	ibn
氿	ivn
汃	iwy
汄	iwy
汅	ignn
汈	ingg
汋	iqyy
汌	ikh
汍	ivyy
汎	iwyy
汏	idy
汑	itan
汒	iynn
汓	ibg
汖	miu
汘	itfh
汙	igfh
汚	ifnn
汢	ifg
汣	iqyy
汥	ifcy
汦	iqan
汧	igah
汫	ifjh
汬	fjiu
汭	imwy
汮	iqug
汯	idcy
汱	idy
汳	ircy
汵	iwyn
汷	ity
汸	iyt
決	inwy
汻	itfh
汼	itgh
汿	icnh
沀	icnh
沄	ifcy
沇	icqn
沊	pqii
沋	idny
沍	igxg
沎	iwxn
沑	inhg
沒	iqcy
沕	iqrt
沖	ikhh
沗	gdiu
沘	ixxn
沚	ihg
沜	ithn
沝	iiy
沞	igmh
沠	irhy
沢	inyy
沨	iwry
沬	ify
沯	idf
沰	idg
沴	iwet
沵	iqiy
沶	ifiy
沷	idcy
沺	ilg
泀	ingk
況	ikqn
泂	imkg
泃	iqkg
泆	itgy
泇	iekg
泈	ituy
泋	ifah
泍	isgg
泎	ithf
泏	ibmh
泑	ixet
泒	ircy
泘	ituf
泙	iguf
泚	ihxn
泜	iqay
泝	iryy
泟	ighg
泤	inyw
泦	invn
泧	iann
泩	itgg
泬	ipwy
泭	iwfy
泲	itnt
泴	ilf
泹	ijgg
泿	ivy
洀	ituy
洂	iyoy
洃	idoy
洅	igmf
洆	ibig
洈	iqdb
洉	irgk
洊	idhb
洍	iahh
洏	idmj
洐	itgs
洑	iwdy
洓	ismn
洔	iffy
洕	iweg
洖	ikgd
洘	iftn
洜	tkiu
洝	ipvg
洟	igxw
洠	ictg
洡	ifsy
洢	iwvt
洣	ioy
洤	iwgg
洦	idjg
洨	iury
洩	ijnt
洬	iwgq
洭	iagg
洯	dhvi
洰	iang
洴	iuah
洶	iqrb
洷	igcf
洸	iigq
洺	iqkg
洿	idfn
浀	imag
浂	iudy
浄	iqvh
浉	ijgh
浌	iway
浐	iutt
浕	inyu
浖	iefy
浗	igiy
浘	inen
浛	iwyk
浝	idny
浟	iwht
浡	ifpb
浢	igku
浤	ipdc
浥	ikcn
浧	ikgg
浨	ipsy
浫	ipwf
浬	ijfg
浭	igjr
浰	itjh
浱	idfe
浲	itdh
浳	iaye
浵	imye
浶	iptg
浹	idww
浺	inkh
浻	imwk
浽	ievg
浾	ifoy
浿	imy
涀	ihqn
涁	iset
涃	ilsy
涄	imgn
涆	ijfh
涇	igva
涊	ivyn
涋	ipdy
涍	iftb
涏	itfp
涐	itry
涒	ivtk
涖	iwug
涗	iwkq
涘	ictd
涙	iynd
涚	iukq
涜	ifpq
涢	ikmy
涥	iybh
涬	ifuf
涭	iepc
涰	iccc
涱	idey
涳	ipwa
涴	ipqb
涶	itgf
涷	isjg
涹	itvg
涺	indg
涻	iwfk
涼	iyiy
涽	iqaj
涾	iijg
淁	iuvg
淂	ijgf
淃	iugb
淈	inbm
淉	ijsy
淊	iqeg
淍	imfk
淎	idwg
淏	ijgd
淐	ijjg
淒	igvv
淓	iayt
淔	ifhg
淕	ifwf
淗	iqoy
淚	iynd
淛	itgj
淜	ieeg
淟	imaw
淢	iakg
淣	ieqn
淥	ixiy
淧	ipnt
淨	ievh
淩	ifwt
淪	iwga
淭	iyns
淯	iyce
淰	iwyn
淲	ihwn
淴	iqrn
淵	ijgg
淶	isww
淸	igmg
淺	iaay
淽	iahg
淾	qiu
淿	irmh
渀	idfa
渁	iiiy
渂	ijyy
渃	iadk
渄	ihdd
渆	iuaj
渇	ijqx
済	iyjg
渉	ihit
渋	ihiy
渏	idsk
渒	irtf
渓	iegy
渕	iudj
渘	icns
渙	iqmd
減	idgk
渜	idmd
渞	iuth
渟	iyps
渢	iwtj
渦	imnk
渧	iyuh
渨	ilge
渪	itky
測	imjh
渮	iask
渰	iwga
渱	ijag
渳	ixbg
渵	ialg
渶	iamd
渷	iukq
渹	iqyg
渻	iith
渼	iugd
渽	ifak
渾	iplh
渿	isfi
湀	iwgd
湁	irwk
湂	ikkn
湅	islg
湆	iujg
湇	iueg
湈	ifsy
湉	intd
湊	idwd
湋	inkg
湌	iwyv
湏	idmy
湐	isrg
湑	inhe
湒	ikbg
湕	ivgp
湗	ifff
湙	iyod
湚	itxn
湜	ijgh
湝	ixxr
湞	ihmy
湠	imdo
湡	ijmy
湢	igkl
湣	inaj
湤	iytb
湥	ipwd
湦	ijtg
湧	icee
湨	ihdy
湩	itgf
湪	ixey
湬	toiu
湭	iusg
湯	ijgr
湰	itgg
湱	idhd
湲	iegc
湳	ifmf
湴	iuog
湵	iugy
湶	iriy
湷	idwj
湸	iypw
湹	idjf
湺	iwks
湻	iyjg
湼	ieag
湽	ivgl
満	iamm
溁	iaps
溂	iskj
溄	imtg
溇	iovg
溈	iyto
溊	inhc
溋	ibcl
溌	iwfq
溍	igoj
溎	isff
溑	iimy
溒	ifke
溓	iuvw
溔	iugo
溕	ipfe
準	iwyf
溗	itux
溙	idwi
溚	iawk
溛	ipwy
溝	iamf
溞	icyj
溠	iuag
溡	ijff
溣	iwwa
溤	icoy
溦	imgt
溨	ifas
溩	iqoy
溫	ilwl
溬	iunc
溭	ilwt
溮	itnh
溰	imgu
溳	ikmy
溵	irvc
溸	igxi
溹	ifpi
溼	igxf
溾	irqc
溿	ilug
滀	iyxl
滃	iwcn
滄	iwyk
滅	idgo
滆	igkh
滈	iymk
滉	ijiq
滊	iroy
滌	iwhs
滍	ibhj
滎	oopi
滐	iqgs
滒	iskk
滖	iyke
滘	ipwk
滙	iawy
滛	ietb
滜	irdf
滝	iujn
滣	idfk
滧	iurt
滪	icnm
滫	iwhe
滬	iync
滭	ijag
滮	ihwe
滯	iaqh
滰	iujq
滱	ipfc
滲	icce
滳	iyuk
滵	ipnm
滶	igqt
滷	ihlo
滸	iytf
滺	iwhn
滻	iutg
滼	issy
滽	iovh
滾	iuke
滿	iamy
漀	fnwi
漁	iqoy
漃	iphc
漄	imdf
漅	ivjs
漇	ithh
漈	iwfi
漊	ilvg
漋	ibtg
漌	iakg
漍	ilag
漎	itwh
漐	fufi
漑	irxq
漒	ixkj
漖	iftt
漗	itln
漘	idfe
漙	igjf
漚	iakk
漛	iugi
漜	issf
漝	inrg
漞	iehq
漟	iipf
漡	itjr
漢	iakg
漣	ilpy
漥	ipwf
漦	ftdi
漧	ifjn
漨	itdp
漬	igmy
漮	iovi
漰	imee
漲	ixde
漴	impi
漵	iwgt
漷	iybb
漸	ilrh
漹	igho
漺	idrr
漻	inwe
漼	imwy
漽	inig
漿	uqfi
潀	ilwy
潁	xidm
潂	imuo
潃	itte
潄	iskt
潅	itgy
潈	iley
潉	imjx
潊	iwgc
潌	ipwf
潎	iity
潏	icnk
潐	iwyo
潑	iwxc
潒	iqke
潓	igjn
潔	idhi
潕	itgo
潖	iggc
潗	iwys
潙	ieto
潚	ivfj
潛	iaqj
潝	iwgn
潟	ieqo
潠	innw
潡	iybt
潣	iuyy
潤	iugg
潥	isoy
潧	iulj
潨	itli
潩	ilaw
潪	itdj
潫	iugi
潬	ikkf
潯	ivaf
潰	ikhm
潱	ifpu
潳	infj
潵	iaet
潶	ilfo
潷	itvg
潹	isss
潻	itwi
潽	iuoj
潾	ioqg
潿	ilng
澀	ivyh
澁	ihhh
澂	imgt
澃	edmi
澅	ivfg
澆	iffq
澇	iooe
澊	iusf
澋	ijyi
澏	ikkm
澐	iffc
澑	igjl
澒	iadm
澓	ittt
澔	irtk
澕	iagg
澖	iusy
澗	iujg
澘	issj
澙	iego
澚	itmn
澛	iqgj
澝	ipne
澞	ihkd
澟	iylt
澠	ixg
澢	iipl
澣	ifjf
澤	ilff
澥	iqeg
澦	icnm
澨	itaw
澩	erri
澪	ifwc
澫	iajy
澬	iuqm
澭	iyxy
澮	iwgj
澯	ihqo
澰	iwgw
澱	inac
澲	iouf
澴	ilge
澵	iusr
澷	ijly
澸	idgn
澺	iujn
澻	iuep
澼	inku
澽	ihge
澾	ifup
澿	issi
濁	ilqj
濃	imae
濄	imnp
濅	ipvc
濆	ifam
濇	ifwk
濈	ikby
濊	ihdh
濋	issh
濌	tgjj
濍	iaqn
濎	ihnn
濏	iggt
濐	ijfj
濓	iutw
濔	igwr
濕	ijxo
濖	ilfj
濗	iajh
濘	ipns
濙	iooo
濚	ioos
濛	iape
濜	ivhl
濝	idwi
濟	iyjg
濢	inyf
濣	ifjf
濤	ifnf
濥	iqpw
濦	iean
濧	iouf
濨	iuxn
濩	iawc
濪	igec
濫	iahl
濬	ihph
濭	iafl
濰	ixwy
濱	ipgm
濲	ifpc
濳	itfj
濴	iooi
濵	ipnm
濶	iutd
濷	iiay
濸	iawk
濹	ijff
濺	imaa
濻	ibkm
濼	irxs
濽	iggm
濾	ihln
濿	iday
瀀	idet
瀁	iugv
瀂	iqoj
瀃	imjr
瀄	itvb
瀅	iooy
瀆	iflm
瀇	ioaw
瀈	inpl
瀉	ipeo
瀊	itul
瀋	iptl
瀌	ioxo
瀍	iojf
瀎	ialw
瀏	iqyj
瀐	ifag
瀒	iswk
瀓	itmt
瀔	ifpc
瀕	ihhm
瀖	ifwy
瀗	ipdn
瀘	ihll
瀙	iusq
瀜	igkj
瀝	idth
瀞	igeh
瀟	iavj
瀠	iooi
瀡	ibdp
瀢	ikhp
瀤	iyle
瀥	inyk
瀦	igej
瀧	iued
瀨	iskm
瀩	itwm
瀪	txti
瀫	ifpc
瀬	iskm
瀭	ilwj
瀮	ifss
瀯	iook
瀰	ixgr
瀱	ildj
瀲	iwgt
瀳	iaoo
瀴	immv
瀶	iahk
瀷	inlw
瀸	iwwg
瀺	iqky
瀻	ifaw
瀼	iyke
瀽	ipah
瀾	iusl
瀿	itxi
灀	ifsh
灁	iuri
灂	ielf
灃	imdu
灄	ibbb
灅	illf
灆	iaal
灇	iouc
灈	ihhy
灉	ivky
灊	iaqh
灋	iogc
灍	iuuw
灎	imal
灐	iooq
灑	igmx
灒	itfm
灓	yxxi
灔	imac
灕	iyry
灖	iosd
灗	ijyg
灘	iaky
灙	iipo
灚	ierq
灛	iukf
灜	iyey
灝	ijym
灟	inij
灠	iahq
灡	iaul
灢	igke
灣	iyxx
灤	iyxs
灥	riri
灦	ijxm
灧	imdc
灨	iujm
灩	imdl
灪	iste
灮	oqb
灱	ovt
灲	ojh
灳	qoi
灴	oag
灷	oaj
灹	otan
灺	obn
灻	fou
災	vou
炁	aqou
炂	owcy
炃	wvou
炄	onhg
炆	oyy
炇	oty
炈	owcy
炋	odhy
炌	owjh
炍	orcy
炏	ooy
炐	odhh
炑	osy
炓	oufh
炗	aou
炘	orh
炚	joy
炛	owxb
炞	oyhy
炟	ojgg
炠	olh
炡	oghg
炢	osyy
炣	oskg
炤	ovkg
炥	oxjh
炦	odcy
炧	otbn
炨	opxn
炩	owyc
炪	obmh
炰	qnou
炲	ockg
炴	omdy
炵	otuy
炶	ohkg
為	ytno
炾	okqn
炿	otmy
烄	oury
烅	otlg
烆	otgs
烇	owgg
烉	qmwo
烋	wsou
烌	owsy
烍	otfq
烎	gaou
烏	qoi
烐	otuy
烑	oqiy
烒	oaay
烓	offg
烔	omgk
烕	dgoi
烖	faoi
烗	oynw
烚	owgk
烜	ogjg
烝	bigo
烞	oshy
烠	odeg
烡	oawu
烢	opta
烣	odoy
烥	oahh
烪	oudy
烮	gqjo
烰	oebg
烱	omwk
烲	rrou
烳	osy
烴	ogva
烵	oaqy
烶	otfp
烸	otxy
烺	oyvy
烻	othp
烼	ogey
烾	ooff
烿	omye
焀	owwk
焁	kqwo
焂	whto
焃	ofoy
焄	vtko
焅	otfk
焆	okeg
焇	oieg
焈	ynno
焋	ufou
焌	ocwt
焍	ouxt
焎	rrou
焏	bkco
焑	olsy
焒	okkg
焔	oqhj
焗	onnk
焛	uoi
焜	ojxx
焝	oqaj
焞	oybg
焟	oajg
焠	oywf
無	tglo
焢	opwa
焣	bcou
焤	owfo
焥	opqb
焧	owcn
焨	ojeg
焩	oeeg
焪	opwx
焫	oamw
焬	ojqr
焭	oopw
焮	orqw
焲	oywy
焳	owyg
焴	oyce
焵	omum
焷	ortf
焸	jjou
焹	omun
焺	ojta
焻	ojjg
焼	ofaq
焽	jeou
焾	owyn
焿	oovw
煀	onbm
煁	odwn
煂	oafh
煃	odff
煄	otgf
煆	onhc
煇	oplh
煈	owtj
煉	oslg
煋	ojtg
煍	otoy
煏	ogkl
煐	oamd
煑	ftjo
煒	onkg
煓	omdj
煔	oohk
煕	ahno
煖	oegc
煗	odmd
煘	odgk
煙	osfg
煚	jano
煛	hhou
煝	onhg
煟	oleg
煠	oans
煡	ovgp
煢	oopf
煣	ocns
煥	oqmd
煩	odmy
煪	ousg
煫	ouey
煬	ojgr
煭	ogqo
煯	oxxr
煰	okkk
煱	omnk
煴	ojlg
煵	ofmf
煶	ojgh
煷	oypw
煹	oamf
煻	oovk
煼	oqbt
煾	oldn
煿	osfy
熀	ojiq
熁	oeee
熂	oroy
熃	cnho
熅	olwl
熆	ofcl
熇	oymk
熈	taho
熉	okmy
熋	cexo
熌	ouwy
熍	opkk
熎	oetb
熐	opju
熑	ouvw
熒	oopo
熓	oqoy
熕	oamy
熖	oeeg
熗	owyk
熚	ojag
熛	osfi
熜	otln
熝	ooxx
熞	oahf
熡	olvg
熢	otdp
熣	omwy
熤	onug
熥	ocep
熦	oiwy
熧	twwo
熩	oync
熪	otqq
熫	ooao
熭	dhdo
熮	onwe
熯	oakg
熰	oakk
熱	fwfo
熲	xodm
熴	omjx
熶	ojbc
熷	oulj
熸	oaqj
熺	ofkk
熻	owgn
熼	olaw
熽	ovfj
熾	oyuj
熿	oamw
燀	okkf
燁	oagg
燂	osjh
燄	qeoo
燅	fwfo
燆	otdk
燇	ousf
燈	owgu
燉	oybt
燊	ooos
燋	owyo
燌	ofam
燍	odwr
燏	ocnk
燐	ooqg
燑	oujf
燒	offq
燓	srro
燖	ovaf
燗	oueg
燘	ouyy
燙	ijgo
燚	oooo
燛	nhao
燜	ouny
燝	ojyi
燞	wyqo
營	oopk
燡	olff
燢	erro
燣	oylt
燤	oajy
燦	ohqo
燨	ougy
燩	oryt
燪	oaqn
燫	oouw
燬	oeac
燭	olqj
燯	ofwc
燰	oept
燱	oujn
燲	oeem
燳	ojvo
燴	owgj
燵	ofup
燶	omae
燷	oyli
燸	ofdj
燺	oyms
燻	otgo
燼	ovhl
燽	ofnf
燾	fnao
燿	onwy
爀	ofoo
爁	oahl
爂	emgo
爃	ooos
爄	oday
爅	olff
爇	afwo
爈	ohln
爉	ovln
爊	ooxo
爋	otge
爌	ooaw
爍	orxs
爎	opdi
爏	odth
爐	ohll
爑	oawo
爒	qodi
爓	ouqe
爔	ougy
爕	yooo
爖	oued
爗	ojag
爘	ohqv
爙	oyke
爚	owga
爛	ousl
爜	oouc
爞	ojjj
爟	oaky
爠	ohhy
爡	oajj
爢	osso
爣	oipo
爤	oaul
爥	onij
爦	oahq
爧	ofkw
爩	oste
爫	etyt
爭	evhj
爮	rhyn
爯	emff
爲	etno
爳	etnb
爴	laky
爺	wrbb
爼	rreg
爾	gwmr
牀	usy
牁	uskg
牂	uuh
牃	uans
牄	uwyk
牅	uovh
牆	ufwk
牉	thgg
牊	thgk
牋	thga
牎	thgn
牏	thgj
牐	thge
牑	thga
牓	thgy
牔	thgf
牕	thgn
牗	thgh
牘	thgm
牚	ipkt
牜	ctgg
牞	cet
牠	cbn
牣	cvyy
牤	cynn
牥	cyt
牨	cywn
牪	ctgh
牫	cay
牬	ctnt
牭	clg
牰	cmg
牱	cskg
牳	cxy
牴	cqay
牶	ugtg
牷	cwgg
牸	cpbg
牻	cdny
牼	cgva
牽	yxpg
犂	tqtg
犃	cukg
犅	cmum
犆	cfhg
犇	tgcg
犈	cugb
犉	cybg
犌	cnhc
犎	fffg
犐	ctuf
犑	chdy
犓	cqbt
犔	croy
犕	cate
犖	oopg
犗	cpdk
犘	ossg
犙	ccce
犚	nfig
犛	ftdg
犜	cybt
犝	cujf
犞	ctdk
犠	cugy
犡	cday
犢	cflm
犣	cvln
犤	clcx
犥	coxo
犦	cjai
犧	cugy
犨	wywg
犩	tvrg
犪	cutt
犫	wyyg
犮	dcyi
犱	qtvy
犲	qtft
犳	qtqy
犵	qttn
犺	qtyw
犻	qtgh
犼	qtbn
犽	qtat
犾	qtdy
犿	qtyh
狀	udy
狅	qttf
狆	qtkh
狇	qtsy
狉	qtdg
狊	hdu
狋	qtfi
狌	qttg
狏	qttb
狑	qtwc
狓	qtby
狔	qtnx
狕	qtxe
狖	qtpw
狘	qtan
狚	qtjg
狛	qtrg
狜	qtdg
狝	qtqi
狟	qtgg
狢	qttk
狣	qtqi
狤	qtfk
狥	qtqj
狦	qtmj
狧	qttd
狪	qtmk
狫	qtfx
狵	qtdy
狶	qtrh
狹	qtdw
狽	qtmy
狾	qtrr
狿	qttp
猀	qtit
猂	qtjf
猄	qtyi
猅	qthd
猆	hdhd
猇	qthw
猈	qtrf
猉	qtdw
猋	dddu
猌	swwd
猍	qtsw
猏	qtye
猐	qtun
猑	qtjx
猒	jedy
猔	qtpi
猘	qttj
猙	qteh
猚	qtwy
猟	qtig
猠	qtmw
猣	qtrt
猤	qtwd
猦	qtwj
猧	qtmk
猨	qtec
猭	qtxe
猯	qtmj
猰	qtdd
猲	qtjn
猳	qtnc
猵	qtya
猶	qtug
猺	qteb
猻	qtbi
猼	qtsf
猽	qtpu
獀	qtec
獁	qtco
獂	qtdi
獃	mgkd
獄	qtyd
獅	qtth
獆	qtrf
獇	qtuc
獈	qtul
獉	qtdt
獊	qtwk
獋	qttf
獌	qtjc
獎	uqfd
獏	qtad
獑	qtlr
獓	qtgt
獔	qtrf
獕	qtmy
獖	qtfm
獘	itdu
獙	qtit
獚	qtaw
獛	qtog
獜	qtog
獝	qtck
獞	qtuf
獟	qtfq
獡	qteo
獢	qttk
獣	ilgd
獤	qtyt
獥	qtrt
獦	qtan
獧	qtle
獨	qtlj
獩	qthh
獪	qtwj
獫	qtww
獮	qtgr
獰	qtps
獱	qtpm
獲	qtac
獳	qtfj
獴	qtae
獵	qtvn
獶	qtdt
獷	qtow
獸	kkld
獹	qthl
獺	qtsm
獻	hgkd
獼	qtxr
獽	qtye
獿	qtdt
玀	qtly
玁	qtkt
玂	qtar
玃	qthc
玅	yxit
玆	yxyx
玈	yxte
玊	gyi
玌	gnn
玍	tff
玏	get
玐	gwy
玒	gag
玓	gqyy
玔	gkh
玕	gfh
玗	ggfh
玘	gnn
玙	ggng
玚	gnrt
玜	gwcy
玝	gtfh
玞	ggy
玠	gwjh
玡	gaht
玣	gyhy
玤	gdhh
玥	geg
玦	gnwy
玧	gcqn
玨	ggg
玪	gwyn
玬	gmyg
玭	gxxn
玱	gwbn
玴	gann
玵	gfg
玶	gguf
玸	gqnn
玹	gyxy
玼	ghxn
玽	gqkg
玾	glh
玿	gvkg
珁	ggny
珃	gmfg
珄	gtgg
珅	gjhh
珆	gckg
珇	gegg
珋	gqtb
珌	gntt
珎	gqiy
珒	gvgh
珓	gury
珔	gdhb
珕	geee
珖	gigq
珗	gtfq
珘	gtuy
珚	gldy
珛	gdeg
珜	guh
珝	gng
珟	gwgq
珡	ggwu
珢	gvy
珣	gqjg
珤	gtfb
珦	gtmk
珨	gwgk
珪	gffg
珫	gycq
珬	gdgg
珮	gwgh
珯	gftx
珰	givg
珱	givg
珳	gyet
珴	gtry
珵	gkgg
珶	guxt
珷	ggay
珸	ggkg
珹	gdnn
珺	gvtk
珻	gtxy
珼	gmy
珽	gtfp
現	ghqn
珿	gkhy
琀	gwyk
琁	gtnh
琂	gyg
琄	gkeg
琇	gtbt
琈	gebg
琋	grdh
琌	gmwn
琍	gtjh
琎	gfjp
琑	gieg
琒	gtdh
琓	gpfq
琔	gpgh
琕	grtf
琖	gaay
琗	gywf
琘	gqaj
琙	gakg
琜	gsww
琝	gjyy
琞	jegy
琟	gwyg
琠	gmaw
琡	ghic
琣	gukg
琤	gqvh
琧	gfgy
琩	gjjg
琫	gdwg
琭	gviy
琯	gpng
琱	gmfk
琲	ghdd
琷	gunn
琸	ghjh
琹	ggsu
琺	gifc
琻	gqg
琽	gftj
琾	glwj
琿	gplh
瑀	gtky
瑂	gnhg
瑃	gdwj
瑄	gpgg
瑅	gjgh
瑆	gjtg
瑇	ggxy
瑈	gcns
瑉	gnaj
瑊	gdgk
瑋	gnkg
瑌	gdmd
瑍	gqmd
瑎	gxxr
瑏	gpwt
瑐	guej
瑑	gxey
瑒	gjgr
瑓	gslg
瑔	griy
瑖	gthc
瑘	gbbh
瑝	grgg
瑠	gqyl
瑡	gtnh
瑢	gpwk
瑣	gimy
瑤	gqtb
瑥	gjlg
瑦	gqoy
瑧	gdwt
瑨	ggoj
瑩	oopy
瑪	gcoy
瑫	geeg
瑬	iycy
瑮	gssy
瑯	gyvb
瑱	gfhw
瑲	gwyk
瑳	guag
瑴	fpgc
瑵	gcyj
瑸	gprw
瑹	gaws
瑺	giph
瑻	gxmy
瑼	ggjf
瑽	gtwh
瑿	atdy
璂	gdwf
璄	gujq
璅	gvjs
璆	gnwe
璈	ggqt
璉	glpy
璊	gamy
璌	gpgw
璍	gagg
璏	gxxx
璑	gtgo
璒	gwgu
璓	gatb
璔	gulj
璕	gvaf
璖	gias
璗	ijgy
璘	goqg
璙	gdui
璚	gcnk
璛	gvfj
璝	gkhm
璟	gjyi
璠	gtol
璡	gwyp
璢	ggjl
璣	gxxw
璤	ggjn
璥	gaqt
璦	gept
璪	gkks
璫	gipl
璬	gryt
璭	gplp
璮	gylg
璯	gwgj
環	glge
璱	gggt
璲	guep
璳	gtfm
璴	gssh
璵	gegw
璶	gvhl
璷	gsyt
璸	gpgm
璹	gfnf
璻	gnyf
璼	gahl
璽	gwmy
璾	gyjg
璿	ghph
瓀	gfdj
瓁	gawc
瓂	gafl
瓃	glll
瓄	gflm
瓅	grxs
瓆	grrm
瓇	gdet
瓈	gtqi
瓉	gggm
瓊	gqmt
瓋	gyup
瓌	gyle
瓍	gbdp
瓎	gskm
瓏	gued
瓐	ghll
瓑	gdth
瓓	gusl
瓔	gmmv
瓕	xgwy
瓖	gyke
瓗	gmwk
瓘	gaky
瓙	gfno
瓚	gtfm
瓛	ghgd
瓝	rcyy
瓟	rcyn
瓡	fufy
瓥	rcyj
瓧	gnnf
瓨	agny
瓩	gnnf
瓪	gnnc
瓫	wvgy
瓬	ygny
瓭	pqgy
瓰	gnnv
瓱	gnne
瓲	gnnn
瓳	dgny
瓵	ckgy
瓸	gnnj
瓹	kegy
瓺	dgny
瓻	rdmy
瓼	gnnf
瓽	ipky
瓾	tvgy
甀	tgay
甁	tgdy
甂	ynmy
甃	togy
甅	gnnf
甆	uxxy
甇	oopy
甈	thsy
甉	uvjy
甊	lvgy
甋	yumy
甌	akky
甎	gjhy
甐	oqgy
甒	tgly
甔	qdwy
甕	yxty
甖	mmgy
甗	hgky
甛	ftdg
甝	hwfd
甞	ipkf
甠	jtgg
甡	tgtg
產	ydtg
産	uttg
甤	getg
甦	gjrg
甧	tgte
甪	tek
甮	qrej
甴	mhfd
甶	tld
甹	mgnb
甼	lsj
甽	lkh
甿	lynn
畁	mgjj
畂	lqyy
畃	jhqy
畄	ilf
畆	ylcy
畇	lqug
畉	lgy
畊	lfjh
畍	lwjh
畐	gklf
畑	olg
畒	ylwy
畓	ilf
畕	llf
畖	lrcy
畗	ylf
畘	lmfg
畝	ylqy
畞	flqy
畟	lwtu
畠	rlf
畡	lynw
畢	jagk
畣	wgkl
畤	lffy
畧	ltkf
畨	olf
畩	lyey
畫	vflg
畬	wgsl
畭	lwgs
畮	ltxy
畯	lcwt
異	lawu
畱	gjal
畳	lpeg
畵	vflb
當	ipkl
畷	lccc
畺	glgg
畻	lugf
畼	ljgr
畽	ltgf
畾	lllf
疀	vlgh
疁	lnwe
疂	lipg
疄	loqg
疅	lglg
疇	lfnf
疈	gkll
疉	lllx
疊	lllg
疌	gvhi
疍	nhjg
疎	nhsk
疐	fplh
疓	ube
疕	uxv
疘	uad
疛	ufi
疜	ughi
疞	ufnv
疢	uoi
疦	unwi
疧	uqav
疨	uaht
疩	uvfk
疪	uxxv
疭	uwwi
疶	uanv
疷	uqay
疺	utpi
疻	ukwi
疿	uxjk
痀	uqkd
痁	uhkd
痆	unxv
痋	uji
痌	umgk
痎	uynw
痏	uded
痐	ulkd
痑	uqqi
痓	ugcf
痗	utxi
痙	ugva
痚	uftb
痜	utwv
痝	udny
痟	uied
痠	ucwt
痡	usi
痥	uukq
痩	ujhc
痬	ujqr
痭	ueed
痮	udei
痯	upnd
痲	ufqq
痳	ussi
痵	utbd
痶	umaw
痷	udjn
痸	utgj
痺	urtf
痻	uqaj
痽	uwyd
痾	ubsk
瘂	ugfg
瘄	uajd
瘆	ucde
瘇	utgf
瘈	udhd
瘉	uwgj
瘋	uwtj
瘍	ujgr
瘎	udwn
瘏	uftj
瘑	umnk
瘒	uplk
瘓	uqmd
瘔	uadd
瘖	uujd
瘚	uubw
瘜	uthn
瘝	ulii
瘞	udwf
瘡	uwyk
瘣	urqc
瘧	uhag
瘨	ufhw
瘬	uxde
瘮	ucce
瘯	uytd
瘱	udwn
瘲	utwh
瘶	uskw
瘷	uskt
瘹	uqqy
瘺	unfi
瘻	ulvd
瘽	uakg
癁	uttt
療	udui
癄	uwyo
癅	ugjl
癆	uooe
癇	uued
癈	uwxc
癉	ukkf
癊	ubwc
癋	ugfn
癎	uujd
癏	ulge
癐	uwgj
癑	umae
癒	uwgn
癓	utmt
癕	uyxy
癗	ufld
癘	uajy
癙	uenn
癚	uqdy
癛	uylt
癝	uyli
癟	utha
癠	uyjd
癡	uxth
癢	uugv
癤	utvb
癥	utmt
癦	ulff
癧	udth
癨	ufwy
癩	uskm
癪	utgm
癬	uqou
癭	ummv
癮	uben
癰	uvky
癱	uaky
癲	ufhm
癳	ulli
癴	uyxr
癵	uyxw
癶	wnyy
癷	wfj
癹	wwcu
発	wfqb
發	wxwc
癿	rnn
皀	rxb
皁	rfj
皃	rqb
皅	rcn
皉	rhxn
皊	rwyc
皌	rgsy
皍	rxbj
皏	ruah
皐	rifj
皒	rtry
皔	rjfh
皕	djdj
皗	rmfk
皘	rgeg
皚	rmgu
皛	rrrf
皜	rymk
皝	rgiq
皞	rrdf
皟	rgmy
皠	rmwy
皡	rrif
皢	rffq
皣	ragg
皥	rthf
皦	rryt
皧	rept
皨	rrrf
皩	rgjq
皪	rrxs
皫	roxo
皬	rfwy
皭	relf
皯	bfh
皰	bqnn
皳	giyb
皵	ajby
皶	sjgb
皷	fkub
皸	plby
皹	bplh
皺	qbtb
皻	hegb
皼	fpgb
皽	ylkb
皾	flmb
盀	hlf
盁	blf
盃	dhlf
盄	xhlf
盇	dylf
盉	tlf
盋	dcyl
盌	qblf
盓	igfl
盕	iwyl
盙	slf
盚	giyl
盜	iqwl
盝	vilf
盞	aalf
盠	xelf
盡	vhgl
盢	ldlf
監	ahnl
盤	tuwl
盦	wynl
盧	hlld
盨	edml
盩	fufl
盪	ijgl
盫	wgkl
盬	ahnl
盭	xful
盰	hfh
盳	hynn
盵	htnn
盶	hfqn
盷	hqug
盺	hrh
盻	hwgn
盽	hdhh
盿	hyy
眀	heg
眂	hqan
眃	hfcy
眅	hrcy
眆	hyt
眊	hen
県	hniu
眎	hfiy
眏	hmdy
眐	hghg
眑	hxet
眒	hjhh
眓	hann
眔	liu
眕	hwet
眖	hkqn
眗	hqkg
眘	duhf
眛	hfy
眜	hgsy
眝	hpsh
眞	xhnw
眡	hqay
眣	htgy
眤	hnxn
眥	hxhf
眧	hvkg
眪	hgmw
眫	hugh
眬	hdxy
眮	hmgk
眰	hgcf
眱	hgxw
眲	hbg
眳	hqkg
眴	hqjg
眹	hudy
眻	huh
眽	hrey
眾	lwww
眿	hyni
睂	wwhh
睄	hieg
睅	hjfh
睆	hpfq
睈	hkgg
睉	hwwf
睊	hkeg
睋	htry
睌	hqkq
睍	hhqn
睎	hrdh
睏	hlsy
睒	hooy
睓	hmaw
睔	hwga
睕	hpqb
睖	hfwt
睗	hjqr
睘	lgke
睙	hynd
睜	hevh
睝	tqth
睞	hsww
睟	hywf
睠	hugb
睤	hlgj
睧	hqaj
睩	hviy
睪	lfuf
睭	hmfk
睮	hwgj
睯	nath
睰	hadk
睱	hnhc
睲	hjtg
睳	hdff
睴	hplh
睵	hfak
睶	hdwj
睷	hvgp
睸	hnhg
睺	hwnd
睻	hpgg
睼	hjgh
瞁	hhdy
瞂	rfhy
瞃	hrfh
瞆	hkhm
瞇	hopy
瞈	hwcn
瞉	fpgc
瞊	hovk
瞋	hfhw
瞏	lfke
瞐	hhhf
瞓	hykh
瞔	hgmy
瞕	hujh
瞖	atdh
瞗	hqoy
瞘	hakk
瞙	hajd
瞚	hpgw
瞛	htwh
瞜	hlvg
瞝	hyrc
瞞	hamy
瞡	hghq
瞣	hkkn
瞤	hugg
瞦	hfkk
瞨	houg
瞫	hsjh
瞭	hdui
瞮	hyct
瞯	hueg
瞱	hagg
瞲	hcnk
瞴	htgo
瞶	hkhm
瞷	hujg
瞸	haas
瞹	hept
瞺	hwgj
瞼	hwgw
瞾	hhpa
矀	htmt
矁	hton
矂	hkks
矃	hpns
矄	htgo
矅	hnwy
矆	hawc
矇	hape
矈	hrpy
矉	hpgm
矊	hxrh
矋	hday
矌	hoaw
矎	hqmt
矏	hthy
矐	hfwy
矑	hhll
矒	halh
矓	hued
矔	haky
矕	yxxh
矖	hgmx
矘	hipo
矙	hunt
矚	hnij
矝	cnhc
矞	cnhk
矟	cnhe
矠	cnhj
矡	cnhc
矤	xtdy
矦	qdtd
矨	tdtd
矪	tdtu
矯	tdtk
矰	tduj
矱	tdac
矲	tdlx
矴	dsh
矵	djh
矷	dbg
矹	dgqn
矺	dtan
矻	dtnn
矼	dag
砃	dmyg
砄	dnwy
砅	diy
砆	dgy
砇	dyy
砈	ddbn
砊	dywn
砋	dhg
砎	dwjh
砏	dwvt
砐	dbyy
砓	dwcy
砕	dvfh
砙	dgny
砛	dwyn
砞	dgsy
砠	degg
砡	dgyy
砢	dskg
砤	dtbn
砨	dynn
砪	dxy
砫	dygg
砮	vcdf
砯	dyiy
砱	dwyc
砲	dqnn
砳	ddg
砵	dsgg
砶	drg
砽	deh
砿	docy
硁	dcag
硂	dwgg
硃	dtfy
硄	digq
硆	dwgk
硈	dfkg
硉	dvgh
硊	dqdb
硋	dynw
硍	dvy
硏	dgdf
硑	duah
硓	dftx
硔	dawy
硘	dlkg
硙	dmnn
硚	dtdj
硛	dyoy
硜	dgva
硞	dtfk
硟	dthp
硠	dyvy
硡	dpdc
硢	dwgs
硣	dftb
硤	ddww
硥	ddny
硦	dgah
硧	dceh
硨	dlh
硩	rrdf
硯	dhqn
硰	iitd
硱	dlsy
硲	dwwk
硳	dfoy
硴	dawx
硵	dhlr
硶	dmwn
硸	dmdf
硹	dswc
硺	dgey
硻	ahnd
硽	ddjn
硾	dtgf
硿	dpwa
碀	dqvh
碁	dwdf
碂	dpfi
碃	dgeg
碄	dssy
碅	dlty
碆	ibdf
碈	dqaj
碊	daay
碋	dmsk
碏	dajg
碐	dfwt
碒	dqg
碔	dgay
碕	ddsk
碖	dwga
碙	dmum
碝	ddmd
碞	kkkd
碠	dyps
碢	dmnk
碤	damd
碦	dptk
碨	dlge
碩	ddmy
碪	ddwn
碫	dthc
碬	dnhc
碭	djgr
碮	djgh
碯	dvtr
碵	dhmy
碶	ddhd
碷	drfh
碸	dwtj
確	dpwy
碻	dymk
碼	dcoy
碽	damy
碿	dnie
磀	dubp
磂	dqyl
磃	drhw
磄	dovk
磆	dmeg
磇	dtlx
磈	drqc
磌	dfhw
磍	dpdk
磎	dexd
磏	duvw
磑	dmgu
磒	dkmy
磓	dtnp
磖	dnrg
磗	dsfy
磘	detb
磚	dgjf
磛	lrdf
磜	dwfi
磝	dgqt
磞	dmee
磟	dnwe
磠	dhlo
磡	ddwe
磢	ddrr
磣	dcce
磤	drvc
磥	dlxi
磦	dsfi
磧	dgmy
磩	ddhi
磪	dmwy
磫	dtwh
磭	ddfe
磮	dmwa
磯	dxxw
磰	duuk
磱	dooe
磳	dulj
磵	dujg
磶	deqo
磸	dusd
磹	dsjh
磻	dtol
磼	dwys
磽	dffq
磾	dkkf
磿	dttd
礀	dueg
礂	dfkk
礃	dipr
礄	dtdk
礆	dwgw
礇	dtmd
礈	duep
礉	dryt
礊	lbwd
礋	dlff
礌	dflg
礍	dajn
礎	dssh
礏	douf
礐	errd
礑	dipl
礒	dugy
礔	dnku
礕	nkud
礖	degw
礗	dpgm
礘	djxo
礙	dxth
礚	dafl
礛	dahl
礜	egnd
礝	dfdj
礟	dcor
礠	duxn
礡	dasf
礢	dugv
礣	dalw
礥	dahm
礦	doaw
礧	dlll
礨	llld
礩	drrm
礪	dday
礫	drxs
礬	srrd
礭	dfwy
礮	dcor
礯	dooi
礰	ddth
礱	uegd
礲	dued
礳	dosd
礵	dfsh
礶	daky
礷	daal
礸	dtfm
礹	dkkt
礽	pybt
礿	pyqy
祂	pybn
祃	pycg
祄	pywj
祅	pytd
祇	pyqa
祊	pyyt
祋	pywc
祌	pykh
祍	pytf
祎	pyfh
祏	pydg
祐	pydk
祑	pytg
祒	pyvk
祔	pywf
祕	pynt
祘	fifi
祙	pyfy
祡	hxfi
祣	pyte
祤	pyng
祦	pykd
祩	pytf
祪	pyqb
祫	pywk
祬	pygf
祮	pyfk
祰	pytk
祱	pyuq
祲	pyvc
祳	pyde
祴	pyaa
祵	pyls
祶	pyut
祹	pyqb
祻	pyld
祼	pyjs
祽	pyyf
祾	pyft
祿	pyxi
禂	pymk
禃	pyfh
禆	pyrf
禇	pyfj
禈	pypl
禉	pyug
禋	pysf
禌	pyux
禍	pymk
禎	pyhm
禐	pyec
禑	pyjy
禒	pyxe
禓	pyjr
禔	pyjh
禕	pyng
禖	pyfs
禗	pyln
禘	pyyh
禙	pyue
禛	pyfw
禜	oopi
禝	pylt
禞	pyyk
禟	pyok
禠	pyrw
禡	pyco
禢	pyjn
禣	pysf
禤	pyln
禥	pydf
禦	ttgi
禨	pyxw
禩	pylw
禪	pykf
禫	pysj
禬	pywj
禭	pyup
禮	pymu
禯	pyme
禰	pygr
禱	pyff
禲	pydy
禴	pywa
禵	pyjm
禶	pytm
禷	pyom
禸	mci
禼	hlrc
禿	tqb
秂	twu
秄	tbg
秅	ttan
秇	tvyy
秈	tmh
秊	ttfj
秌	oty
秎	twvt
秏	ten
秐	tfcy
秓	tfcy
秔	tywn
秖	tqan
秗	ttdy
秙	tdg
秚	tugh
秛	tby
秜	tnxn
秝	tty
秞	tmg
秠	tdhg
秡	tdcy
秢	twyc
秥	thkg
秨	tthf
秪	tqay
秬	tang
秮	tckg
秱	tmgk
秲	tffy
秳	ttdg
秴	twgk
秵	tldy
秶	uqwt
秷	tgcf
秹	twtf
秺	tpta
秼	ttfy
秾	tpey
秿	tsy
稁	yptu
稄	tcwt
稅	twkq
稇	tlsy
稈	tjfh
稉	tgjr
稊	tuxt
稌	twgs
稏	tgfg
稐	twga
稑	tfwf
稒	tldg
稓	tajg
稕	tybg
稖	tukg
稘	tdwy
稙	tfhg
稛	tlty
稜	tfwt
稝	teeg
稟	ylkt
稡	tywf
稢	takg
稤	tyiy
稥	tojf
稦	tnkg
稧	tdhd
稨	tyna
稩	tleg
稪	ttjt
稫	tgkl
稬	tdmd
稭	txxr
種	ttgf
稯	trbt
稰	tnhe
稱	temf
稲	tehj
稴	tuvw
稵	tuxx
稶	takr
稸	tyxl
稺	tnuh
稾	ymkt
穀	fpgc
穁	tabg
穂	tgmn
穃	tpwk
穄	twfi
穅	tovi
穇	tcce
穈	osst
穉	tnig
穊	tvaq
穋	tnwe
穌	qoty
積	tgmy
穎	xtdm
穏	tevn
穐	tqjn
穒	tqou
穓	tlaw
穔	tamw
穕	twys
穖	txxw
穘	tffq
穙	toug
穚	ttdk
穛	twyo
穜	tujf
穝	tjbc
穞	tqgj
穟	tuep
穠	tmae
穡	tfwk
穢	thdh
穣	tuae
穤	tfdj
穥	tegw
穦	tpgm
穧	tyjg
穨	twkm
穩	tean
穪	tgwr
穫	tawc
穬	toaw
穭	tqoj
穮	toxo
穯	tfkk
穱	telf
穲	tgmx
穳	ttfm
穵	pwnb
穻	pwgf
穼	pwsu
穽	pwfj
穾	pwtd
窂	pwtg
窅	pwhf
窇	pwqn
窉	pwgw
窊	pwry
窋	pwbm
窌	pwqb
窎	pwqg
窏	pwif
窐	pwff
窓	pwcn
窔	pwur
窙	pwfb
窚	pwdn
窛	pwfv
窞	pwqe
窡	pwcc
窢	pwag
窣	pwyf
窤	pwjx
窧	pwhj
窩	pwmk
窪	pwif
窫	pwdd
窮	pwtx
窯	pwuo
窰	pweb
窱	pwws
窲	pwof
窴	pwfw
窵	pwqo
窶	pwlv
窷	pwbb
窸	pwtn
窹	pwuk
窺	pwgq
窻	pwtn
窼	pwvs
窽	pwxw
窾	pwfw
竀	pwgq
竁	pwee
竂	pwdi
竃	pwfn
竄	pwen
竅	pwrt
竆	pwtk
竇	pwfm
竈	pwfx
竉	pwud
竊	pwtc
竌	uwn
竍	ufh
竎	uaj
竏	utfh
竐	uwcy
竑	udcy
竒	ukhj
竓	uen
竔	utah
竕	uwvt
竗	uitt
竘	uqkg
竚	upsh
竛	uwyc
竜	ujnb
竝	uug
竡	udjg
竢	uctd
竤	updc
竧	utmt
竨	uhjh
竩	upeg
竪	ahnu
竫	uqvh
竬	utky
竮	unua
竰	udjf
竱	ugjf
竲	uulj
竳	uwgu
竴	uusf
竵	ugkh
競	ukqq
竷	ujtt
竸	ujqq
竻	ter
竼	twyu
竾	tbb
笀	tynb
笁	taf
笂	tvyu
笅	trru
笇	tyhu
笉	tquf
笌	taht
笍	tmwu
笎	tfqb
笐	tywb
笒	twyn
笓	txxb
笖	tnyw
笗	ttuu
笘	thkf
笚	tlj
笜	tbmj
笝	tlcu
笟	trcy
笡	tegf
笢	tnab
笣	tqnb
笧	tmmg
笩	tway
笭	twyc
笯	tvcu
笰	txjj
笲	tcaj
笴	tskf
笵	tibb
笶	ttdu
笷	tqtb
笹	tanb
笻	tabj
笽	tlf
笿	ttkf
筀	tfff
筁	tmaf
筂	tibb
筃	tldu
筄	tqiu
筆	tvgj
筈	ttdf
筊	turu
筍	tqjf
筎	tvkf
筓	tgdf
筕	ttgs
筗	twkh
筙	tfsu
筜	tivf
筞	tpsu
筟	tebf
筡	twgs
筣	ttjj
筤	tyvu
筥	tkkf
筦	tpfq
筧	thqb
筨	twyk
筩	tcej
筪	talj
筫	tmu
筬	tdnb
筭	tgaj
筯	tege
筰	twtf
筳	ttfp
筴	tdww
筶	ttfk
筸	tjfj
筺	tagy
筼	tkmu
筽	tkgd
筿	ttsu
箁	tukf
箂	tsww
箃	tbcu
箄	trtf
箆	tmwx
箇	tldf
箈	tick
箉	trke
箊	tywu
箋	taau
箌	tgcj
箎	thwb
箏	tevh
箑	tgvh
箒	tvph
箓	tviu
箖	tssu
箘	tltu
箙	tebc
箚	twgj
箛	tbry
箞	tugb
箟	tjxx
箠	ttgf
箣	tsmj
箤	tywf
箥	tibu
箮	tpgg
箯	twgr
箰	tqjb
箲	titq
箳	tnua
箵	tith
箶	tdef
箷	tytb
箹	txqy
箺	tdwj
箻	ttvg
箼	tngf
箽	ttgf
箾	tiej
箿	tkbf
節	tvbj
篂	tjtg
篃	tnhf
範	tlbb
篅	tmdj
篈	tfff
築	taws
篊	tiaw
篋	tadw
篍	ttou
篎	thit
篏	tfqw
篐	tsah
篒	twyv
篔	tkmu
篕	tfcl
篖	tovk
篗	twyc
篘	tqbt
篛	txuu
篜	tbio
篞	tijf
篟	twge
篠	twhs
篢	tamu
篣	tyuy
篤	tcou
篧	tpwy
篨	tbws
篩	ttnh
篫	tawr
篬	twyk
篭	tujn
篯	tqga
篰	tukb
篲	tdhv
篳	tjag
篴	tgep
篵	ttwh
篶	tgho
篸	tcce
篹	thdb
篺	trrf
篻	tsfi
篽	tttb
篿	tgjf
簀	tgmu
簁	tthh
簂	tlag
簃	ttqq
簄	tync
簅	tutg
簆	tpft
簈	tntf
簉	ttfp
簊	tdwf
簍	tlvf
簎	traj
簐	tlqw
簑	tyke
簒	thdc
簓	tmfe
簔	tyge
簕	tafe
簗	tivs
簘	tvoj
簙	tfsf
簚	tlah
簛	tdwr
簜	tijr
簝	tdui
簞	tkkf
簠	tslf
簡	tujf
簢	tuyu
簣	tkhm
簤	tlmu
簥	ttdk
簨	tnnw
簩	tooe
簫	tvfj
簬	tkhk
簭	tawk
簮	tggj
簯	tsdw
簰	tthf
簱	tydw
簲	terf
簳	tfjf
簴	thow
簵	tltk
簶	tpyi
簷	tqdy
簹	tipl
簺	tpaf
簻	tmnp
簼	traf
簽	twgw
簾	touw
籂	twvh
籃	tahl
籄	takm
籅	tegw
籆	tawc
籇	type
籈	tsfy
籉	tfkf
籊	tnwy
籋	tgwr
籌	tfnf
籎	txth
籏	tytw
籐	teui
籑	thdv
籒	trgl
籓	titl
籔	tlvt
籕	tsql
籖	tfag
籗	tfwy
籘	teui
籙	tqvi
籚	thll
籛	tqaa
籜	trlf
籝	tyey
籞	ttti
籟	tskm
籠	tued
籡	trww
籢	twgt
籣	tusl
籤	twwg
籥	twga
籦	tqtf
籧	thgp
籨	twgw
籩	tthp
籪	txxr
籫	ttfm
籬	tyry
籭	tgmx
籮	tlxy
籯	tyey
籰	thhc
籱	tfwy
籲	twgm
籵	ofh
籶	own
籷	otan
籸	onfh
籹	ovg
籺	otnn
籾	ovyy
籿	ofy
粀	odyy
粁	otfh
粂	qyou
粃	oxxn
粄	orcy
粅	oqrt
粆	oitt
粇	oywn
粈	onhg
粊	xxou
粋	ovfh
粌	oxhh
粍	oen
粎	onyy
粏	odyy
粐	oynt
粓	ofg
粔	oang
粖	ogsy
粙	omg
粚	otbn
粛	vojk
粠	oawy
粡	omgk
粣	ommg
粦	oqgj
粧	oofg
粨	odjg
粩	oftx
粫	odmj
粬	omag
粭	owgk
粯	ohqn
粰	oebg
粴	ojfg
粵	tmtn
粶	oviy
粷	oqoy
粸	odwy
粺	ortf
粻	odey
粿	ojsy
糀	oawx
糂	odwn
糃	ojgr
糄	oyna
糆	odlf
糉	orbt
糋	ouej
糎	odjf
糏	onie
糐	osfy
糑	oxuu
糒	oate
糓	fpgc
糔	ocyj
糘	opge
糚	oauf
糛	oipf
糝	occe
糞	olaw
糡	oujq
糢	oajd
糣	oaqj
糤	oaet
糥	odmj
糦	ofkk
糧	ojgf
糩	owgj
糪	nkuo
糫	olge
糬	olfj
糭	oobt
糮	oahl
糰	olgf
糱	btto
糲	oday
糳	oufo
糴	tyoy
糵	atno
糶	bmoy
糷	oaul
糹	xnny
糺	xnn
糼	xet
糽	xsh
糾	xnhh
糿	xvt
紀	xnn
紁	xcyy
紂	xfy
紃	xkh
約	xqyy
紅	xag
紆	xgfh
紇	xtnn
紈	xvyy
紉	xvyy
紋	xyy
紌	xdny
納	xmwy
紎	xdy
紏	xufh
紐	xnhg
紑	xdhy
紒	xwjh
紓	xcnh
純	xgbn
紕	xxxn
紖	xxhh
紗	xitt
紘	xdcy
紙	xqan
級	xbyy
紛	xwvt
紜	xfcy
紝	xtfg
紞	xpqn
紟	xwyn
紡	xyt
紣	xvfh
紤	xrh
紥	rnxi
紦	xcn
紨	xwfy
紩	xtgy
紪	xhxn
紬	xmg
紭	xxcy
紮	snxi
細	xlg
紱	xdcy
紲	xann
紳	xjhh
紴	xby
紵	xpsh
紶	xfcy
紷	xwyc
紸	xygg
紹	xvkg
紺	xfg
紻	xmdy
紼	xxjh
紽	xpxn
紾	xwet
紿	xckg
絀	xbmh
絁	xtbn
終	xtuy
絃	xyxy
組	xegg
絅	xmkg
絆	xugh
絇	xqkg
絈	xrg
絉	xsyy
絊	xsgg
絋	xocy
経	xcfg
絍	xwtf
絎	xtgs
絏	xjnt
結	xfkg
絑	xtfy
絒	xyth
絓	xffg
絔	xdjg
絕	xvcn
絖	xigq
絗	xlkg
絘	xuqw
絙	xgjg
絚	xghg
絛	whti
絜	dhvi
絝	xdfn
絞	xury
絟	xwgg
絠	xdeg
絡	xtkg
絢	xqjg
絣	xuah
絤	xsg
絥	xwdy
給	xwgk
絧	xmgk
絨	xadt
絩	xqiy
絪	xldy
絫	ccci
絬	xtdg
絭	ugxi
絯	xynw
絰	xgcf
統	xycq
絲	xxiy
絳	xtgh
絴	xuh
絵	xwfc
絶	xqcn
絸	xhqn
絹	xkeg
絺	xrdh
絻	xqkq
絼	xet
絽	xkkg
絾	xdnn
絿	xgiy
綀	xskg
綁	xdtb
綂	xyqn
綃	xieg
綄	xpfq
綅	xvpc
綆	xgjr
綇	xsgg
綈	xuxt
綉	xtbt
綊	xdww
綋	xpdc
綌	xwwk
綍	xfpb
綎	xtfp
綏	xevg
綐	xukq
綑	xlsy
綒	xebg
經	xgva
綔	dfni
綕	xfny
綖	xthp
綗	xmwk
綘	xtdh
継	xonn
続	xfpq
綛	xvyn
綜	xpfi
綝	xssy
綞	xtgf
綟	xynd
綠	xxiy
綡	xyiy
綢	xmfk
綣	xugb
綤	vkbi
綥	xlgj
綧	xybg
綨	xdwy
綩	xpqb
綪	xgeg
綫	xaay
綬	xepc
維	xwyg
綯	xqtb
綰	xpng
綱	xmum
網	xmun
綳	xeeg
綴	xccc
綵	xesy
綶	xjsy
綷	xywf
綸	xwga
綹	xthk
綺	xdsk
綻	xpgh
綼	xrtf
綽	xhjh
綾	xfwt
綿	xrmh
緀	xgvv
緁	xgvh
緂	xooy
緃	xwwh
緄	xjxx
緅	xbcy
緆	xjqr
緇	xvlg
緈	xfuf
緉	xgmy
緊	ahni
緋	xhdd
緌	xtvg
緍	xqaj
緎	xakg
総	xwcn
緐	txti
緑	xviy
緒	xftj
緓	xamd
緔	ximk
緕	xyjg
緖	xftj
緗	xshg
緘	xdgk
緙	xafh
線	xriy
緛	xdmd
緜	rmhi
緝	xkbg
緞	xthc
緟	xtgf
締	xyuh
緡	xnaj
緢	xalg
緣	xxey
緤	xans
緥	xwks
緦	xlny
緧	xusg
編	xyna
緩	xegc
緪	xngg
緫	xqrn
緬	xdlf
緭	xleg
緮	xtjt
緯	xnkg
緰	xwgj
緱	xwnd
緲	xhit
緳	odhi
練	xslg
緵	xrbt
緶	xwgr
緷	xplh
緸	xsfg
緹	xjgh
緺	xmnk
緻	xgct
緼	xjlg
緽	xhmy
緾	xdjf
緿	xckn
縀	xnhc
縁	xvey
縂	xukn
縃	xnhe
縄	xjjn
縅	xdgv
縆	xngg
縇	xpgg
縈	oopi
縉	xgoj
縊	xuwl
縋	xtnp
縌	xubp
縍	xyuy
縎	xmeg
縏	tuwi
縐	xqbt
縑	xuvw
縒	xuag
縓	xdri
縔	xccs
縕	xlwl
縖	xpdk
縗	xyke
縘	xexd
縙	xabg
縚	xeeg
縛	xsfy
縜	xkmy
縝	xfhw
縞	xymk
縟	xdff
縠	fpgc
縡	xpuh
縢	eugi
縣	hiti
縤	xgxi
縥	xdwt
縦	xtuh
縧	xwhs
縨	xjiq
縩	xwfi
縪	xjag
縫	xtdp
縬	xdhi
縭	xyrc
縮	xpwj
縯	xpgw
縰	xthh
縱	xtwh
縲	xlxi
縳	xgjf
縴	xyxg
縵	xjlc
縶	fufi
縷	xlvg
縸	xajd
縹	xsfi
縺	xlpy
縼	xyth
總	xtln
績	xgmy
縿	xcce
繀	xmwy
繂	xyxf
繃	xmee
繄	atdi
繅	xvjs
繆	xnwe
繈	xxcj
繉	xhqi
繊	xfao
繋	lwci
繌	xtlt
繍	xvoj
繎	xqdo
繏	xnnw
繐	xgjn
繑	xtdk
繒	xulj
繓	xjbc
織	xyuj
繕	xuuk
繖	xaet
繗	xoqg
繘	xcnk
繙	xtol
繚	xdui
繛	gxij
繜	xusf
繝	xueg
繞	xffq
繟	xkkf
繠	nnni
繡	xvfj
繢	xkhm
繣	xvfg
繤	ahdi
繥	xfkk
繦	xxkj
繧	xffc
繨	xfup
繩	xxg
繪	xwgj
繫	lbwi
繬	xfwk
繭	amhj
繮	xglg
繯	xlge
繰	xkks
繱	xaqn
繲	xqeg
繳	xryt
繴	nkui
繵	xylg
繶	xujn
繷	xmae
繸	xuep
繹	xlff
繺	xqvo
繻	xfdj
繼	xxxn
繽	xpgm
繾	xkhp
繿	xahl
纀	xwog
纁	xtgo
纃	xyjg
纄	xatp
纅	xrxs
纆	xlff
纇	oxim
纈	xfkm
纉	xggm
纊	xoaw
纋	xdet
續	xflm
纍	llli
纎	xfag
纏	xojf
纐	xurm
纑	xhll
纒	xojf
纓	xmmv
纔	xqky
纕	xyke
纖	xwwg
纗	xmwk
纘	xtfm
纙	xlxy
纚	xgmx
纜	xahq
纝	xlli
纞	xyxn
纮	xdcy
纴	xtfg
纻	xpgg
纼	xxhh
绖	xgcf
绤	xwwk
绬	xamd
绹	xqtb
缊	xjlg
缐	xriy
缞	xyke
缷	tfbb
缹	tfbo
缻	tfby
缼	tfbw
缽	tfbg
缾	tfba
缿	tfbk
罀	tfbi
罁	tfbm
罃	oopb
罆	tfbm
罇	tfbf
罈	tfbj
罉	tfbr
罊	lbwb
罋	yxtb
罌	mmtb
罍	lllb
罎	tfbc
罏	tfbl
罒	lhng
罓	mri
罖	lwyu
罙	pwsu
罛	lrcy
罜	lygf
罝	legf
罞	lcnt
罠	lnab
罣	lfff
罤	luxt
罥	lkef
罦	lebf
罧	lssu
罫	lffh
罬	lccc
罭	lakg
罯	lujf
罰	lyjj
罳	llnu
罵	lcou
罶	lqyl
罷	lcex
罸	lyfu
罺	lvjs
罻	lnff
罼	ljag
罽	ldoj
罿	lujf
羀	mrrl
羂	lxke
羃	lajh
羄	lxhj
羅	lxwy
羆	lceo
羇	lafk
羈	lafo
羉	lyxi
羋	hghg
羍	duj
羏	uet
羐	hghy
羑	ugqy
羒	uwvt
羓	ucn
羕	ugyi
羖	uwcy
羗	unci
羘	euh
羙	ugou
羛	ugxj
羜	upsh
羠	ugxw
羢	uadt
羣	vtku
羥	ugva
羦	upfq
羨	ugiw
義	ugty
羪	uyvy
羫	upwa
羬	udgk
羭	uwgj
羮	ugog
羱	udri
羳	utol
羴	uuuj
羵	ufam
羶	uylg
羷	uwgw
羺	ufdj
羻	uont
羾	nag
翀	nkhh
翂	nwvt
翃	dcng
翄	nfcy
翆	nvfj
翇	ndcy
翈	lng
翉	sgng
翋	nug
翍	nby
翏	nwer
翐	ntgy
翑	nqkg
習	nrf
翓	fkng
翖	wgkn
翗	qqng
翙	mqng
翚	nplj
翛	whtn
翜	ndww
翝	pdcn
翞	nyiy
翢	mfkn
翣	nuvf
翤	kman
翧	pgjn
翨	njgh
翪	nrbt
翫	nrfq
翬	nplj
翭	nwnd
翯	nymk
翲	sfin
翴	nlpy
翵	nqoy
翶	rifn
翷	oqgn
翸	famn
翹	fffn
翺	thin
翽	hdgn
翾	lgkn
翿	fnan
耂	fte
耇	ftqk
耈	ftxk
耉	fttk
耊	ftgf
耎	dmjd
耏	dmje
耑	mdmj
耓	fssh
耚	fsby
耛	fsck
耝	fseg
耞	fsek
耟	fsan
耡	fsee
耣	fswa
耤	fsaj
耫	fsgm
耬	fslv
耭	fsxw
耮	fsoe
耯	fsac
耰	fsdt
耲	fsye
耴	bnn
耹	bwyn
耺	bfcy
耼	bmfg
耾	bdcy
聀	bay
聁	bwvt
聄	bwet
聅	btdy
聇	bghg
聈	bxet
聉	bbmh
聎	bqiy
聏	bdmj
聐	bfkg
聑	bbg
聓	awyb
聕	btfk
聖	bkgf
聗	bdww
聙	bgeg
聛	brtf
聜	bpwa
聝	bakg
聞	ubd
聟	tdkb
聠	buah
聡	bwcn
聢	bpgh
聣	beqn
聤	byps
聥	btky
聦	bqrn
聧	bwgd
聨	bxxa
聫	bxxd
聬	bwcn
聭	brqc
聮	bxxo
聯	bxxg
聰	btln
聲	fnwb
聳	twwb
聴	bfln
聵	bkhm
聶	bbbf
職	byuj
聸	bqdy
聹	bpns
聺	bpwi
聻	ilrb
聼	nbfn
聽	bgfn
聾	uegb
肁	ynvg
肂	gqvg
肅	vfjk
肈	ynag
肊	enn
肍	evn
肎	pef
肏	tymw
肐	etnn
肑	eqyy
肒	evyy
肔	ebn
肕	evyy
肗	evg
肙	kef
肞	eyry
肣	ewyn
肦	muwv
肧	edhy
肨	edhh
肬	edny
肰	edy
肳	eqrt
肵	erh
肶	exxn
肸	ewfh
肹	ewgn
肻	hpef
胅	etgy
胇	exjh
胈	edcy
胉	erg
胊	muqk
胋	ehkg
胏	etnt
胐	mubm
胑	ekwy
胒	enxn
胓	eguf
胔	hxmw
胕	ewfy
胘	eyxy
胟	exy
胠	efcy
胢	eskg
胣	etbn
胦	emdy
胮	etgh
胵	egcf
胷	qrbe
胹	edmj
胻	etgs
胾	famw
胿	effg
脀	bige
脁	muqi
脃	eqcn
脄	edoy
脅	eeee
脇	eeee
脈	erey
脋	vvve
脌	etgh
脕	eqkq
脗	eqrk
脙	egiy
脛	egva
脜	edhg
脝	eybh
脟	eefy
脠	ethp
脡	etfp
脢	etxy
脣	dfee
脤	edfe
脥	edww
脦	eany
脧	muct
脨	eskg
脩	whte
脪	erdh
脫	ewkq
脭	ekgg
脮	eevg
脰	egku
脳	eirb
脴	edhk
脵	ekgd
脷	etjh
脹	edey
脺	eywf
脻	egvh
脼	egmy
脽	ewyg
脿	egey
腀	ewga
腁	etgf
腂	ejsy
腃	eugb
腄	etgf
腅	eooy
腇	etvg
腉	eeqn
腍	ewyn
腎	ahne
腏	eccc
腒	endg
腖	esjg
腗	emgj
腘	elgy
腛	engf
腜	efsy
腝	edmd
腞	exey
腟	epgf
腡	emnk
腢	ejmy
腣	eyuh
腤	eujg
腦	evtr
腨	emdj
腪	eplh
腫	etgf
腬	ecns
腯	erfh
腲	elge
腳	ewwb
腵	enhc
腶	ethc
腷	egkl
腸	ejgr
膁	euvw
膃	elwl
膄	eehc
膅	eovk
膆	egxi
膇	etnp
膉	euwl
膋	oope
膌	eiwe
膍	etlx
膎	eexd
膐	ytew
膒	eakk
膓	etjr
膔	eoxx
膕	elag
膖	etdp
膗	emwy
膙	exkj
膚	hled
膞	egjf
膟	eyxf
膠	enwe
膡	eugh
膢	elvg
膤	efvg
膥	gsdw
膧	muuf
膩	eafy
膫	edui
膬	eeee
膭	ekhm
膮	effq
膯	ewgu
膰	etol
膱	eyuj
膲	ewyo
膴	etgo
膵	eayf
膶	eugg
膷	extb
膸	edap
膹	efam
膼	emnp
膽	eqdy
膾	ewgj
膿	emae
臄	ehge
臅	elqj
臇	ewyn
臈	eajn
臉	ewgw
臋	naww
臍	eyjg
臎	enyf
臏	epgm
臐	etgo
臑	efdj
臒	eawc
臓	eadh
臔	eahm
臕	eoxo
臖	emge
臗	epay
臘	evln
臙	eako
臚	ehll
臛	efwy
臜	etfm
臝	yejy
臞	ehhy
臟	eaah
臠	yxxw
臡	akgw
臢	etfm
臤	ahnc
臥	ahnw
臦	nhah
臨	ahnk
臩	nhaj
臫	thnn
臮	thwy
臯	thif
臰	thgx
臱	thpy
臲	thsb
臵	gcfk
臶	gcfb
臷	fagf
臸	gcff
臹	gcfn
臺	fkpf
臽	qef
臿	tfed
舃	egno
與	egnw
興	emgw
舉	egng
舊	awye
舋	emgg
舎	wfkf
舏	tdnh
舑	tdmf
舓	tdjr
舕	tdoo
舖	wfks
舗	wfks
舘	wfkn
舙	tdtd
舚	tdqy
舝	nvpg
舠	tuvt
舤	tuwy
舥	tucn
舦	tudy
舧	tuty
舩	tuwc
舮	tuyn
舲	tuwc
舺	tulh
舼	tuaw
舽	tutg
舿	tudn
艀	tueb
艁	tutk
艂	tuth
艃	tujf
艅	tuws
艆	tuyv
艈	tuyk
艊	turh
艌	tuwn
艍	tund
艎	turg
艐	turt
艑	tuya
艒	tujh
艓	tuas
艔	tuoc
艕	tuyy
艖	tuua
艗	tuul
艙	tuwk
艛	tulv
艜	tuah
艝	tufv
艞	tuti
艠	tuwu
艡	tuil
艢	tufk
艣	tuhe
艤	tuuy
艥	tuky
艦	tual
艧	tuac
艩	tuyj
艪	tuqj
艫	tuhl
艬	tuqy
艭	tuwc
艱	akgv
艵	uaqc
艶	magc
艷	mdhc
艸	btbh
艻	aer
艼	asj
芀	avr
芁	awb
芃	awyu
芅	aayu
芆	acyu
芇	amhj
芉	afj
芌	afnb
芐	aghu
芓	abf
芔	bhbh
芕	aqu
芖	adu
芚	agbn
芛	avtr
芞	arb
芠	ayu
芢	awff
芣	adhu
芧	acnh
芲	awxb
芵	anwu
芶	aqcu
芺	atdu
芻	qbtt
芼	aeb
芿	awbr
苀	aywb
苂	aou
苃	adcu
苅	arjj
苆	aavr
苉	aaqb
苐	axht
苖	amf
苙	auf
苚	aej
苝	auxb
苢	anf
苧	apsj
苨	anxb
苩	arf
苪	agmw
苬	alwu
苭	axer
苮	awmj
苰	axcu
苲	athf
苳	atuu
苵	atgu
苶	awiu
苸	atuf
苺	axu
苼	atgf
苽	arcy
苾	antr
苿	afu
茀	axjj
茊	arf
茋	aqay
茍	hghk
茐	aqry
茒	aqbj
茓	apwu
茖	atkf
茘	avvv
茙	aadr
茝	aahh
茞	aahh
茟	avgj
茠	awsu
茡	apbf
茢	agqj
茣	akgd
茤	aqqu
茥	afff
茦	asmb
茩	argk
茪	aigq
茮	ahiu
茰	ajru
茲	axxu
茷	awau
茻	btbh
茽	awkh
茾	agaj
茿	aawy
荁	agjg
荂	adfn
荄	aynw
荅	awgk
荈	aqgj
荊	agaj
荋	admj
荌	apvf
荍	anht
荎	agcf
荓	auaj
荕	aeer
荖	aftx
荗	aawu
荘	auff
荙	adpu
荝	amjj
荢	apgf
荰	asff
荱	aneb
荲	ajff
荳	agku
荴	argu
荵	avyn
荶	akwn
荹	ahhr
荺	afqu
荾	acwt
荿	adnb
莀	adfe
莁	aaww
莂	akej
莃	ardh
莄	agjr
莇	aege
莈	aiwc
莊	auff
莋	awtf
莌	aukq
莍	agiy
莏	arit
莐	aipq
莑	atdh
莔	alwm
莕	askf
莖	agva
莗	alj
莙	avtk
莚	athp
莝	awwf
莟	awyk
莡	akhu
莢	adww
莣	aynn
莤	asgf
莥	aqtg
莦	aief
莧	ahqb
莬	aqkq
莭	avbj
莮	aler
莯	aisu
莵	atky
莻	abkx
莾	adfa
莿	asmj
菂	arqy
菃	aian
菄	asjf
菆	abcu
菈	aruf
菉	aviu
菋	akfu
菍	awyn
菎	ajxx
菐	ougu
菑	avlf
菒	ajsu
菓	ajsu
菕	awga
菗	armf
菙	atgf
菚	aaau
菛	auf
菞	atqt
菢	arqn
菣	aahc
菤	augb
菦	arpu
菧	aoqy
菨	auvf
菫	agkg
菬	aivk
菭	aick
菮	aovw
華	agag
菳	aqf
菴	adjn
菵	amun
菶	adwg
菷	avph
菺	ayne
菻	assu
菼	aoou
菾	agdn
菿	agcj
萀	ahwb
萂	atkf
萅	agbj
萇	adeu
萈	ahqy
萉	aecb
萊	asww
萐	agvh
萒	aucq
萓	apeg
萔	arvk
萕	ayjf
萖	aeqb
萗	apfi
萙	aspq
萚	arcg
萛	ahaj
萞	amwx
萟	atvy
萠	aeef
萡	airf
萢	aiqn
萣	apgh
萩	atou
萪	atuf
萫	atjf
萬	ajmy
萭	atky
萮	awgj
萯	aqmu
萰	aslf
萲	aegc
萳	afmf
萴	amjj
萵	amnk
萶	adwj
萷	aiej
萹	ayna
萺	ajhf
萻	aujf
萾	abcl
萿	aitd
葀	artd
葁	augv
葂	aqke
葃	ajtf
葄	aetf
葅	awwg
葇	acns
葈	acks
葉	aans
葊	awga
葋	aeqk
葌	avvv
葍	agkl
葎	atvg
葏	aivg
葐	awvl
葒	axaf
葓	aiaw
葔	awnd
葕	atis
葖	apwd
葘	avgl
葝	agve
葞	axbf
葟	argf
葠	awvc
葢	adyl
葤	axfu
葥	auej
葦	ankg
葧	afpe
葨	alge
葪	aqej
葮	athc
葯	axqy
葰	awct
葲	ariu
葴	adgk
葷	aplj
葹	aytb
葻	awtj
葼	arbt
葽	asvf
葾	aqbn
葿	anhf
蒀	ajlf
蒁	asyp
蒃	axeu
蒄	apff
蒅	aivs
蒆	aawv
蒊	awxx
蒍	ayto
蒏	apsg
蒐	arqc
蒑	arvc
蒒	atnh
蒓	axgn
蒔	ajff
蒕	alwl
蒖	afhw
蒘	avkr
蒚	agkh
蒛	atfw
蒝	adri
蒞	aiwu
蒟	auqk
蒠	athn
蒢	abws
蒣	atws
蒤	aiws
蒥	aqyl
蒦	awyc
蒧	adhk
蒨	awge
蒩	ateg
蒪	asfu
蒫	auaf
蒬	apqy
蒭	aqbt
蒮	apwy
蒰	atuc
蒱	arsu
蒳	axmw
蒵	aexd
蒶	axwv
蒷	akmu
蒻	axuu
蒼	awyk
蒾	aopu
蓀	abti
蓂	apju
蓃	aehc
蓅	aiyk
蓆	aoah
蓇	amef
蓈	ayvb
蓋	afcl
蓌	awwt
蓎	aovk
蓏	arcy
蓒	alfj
蓔	augo
蓕	asff
蓗	atfh
蓘	auce
蓙	aowf
蓚	awhe
蓛	asmt
蓜	asgn
蓞	aeef
蓡	aivc
蓢	ayve
蓤	auft
蓧	awhs
蓨	awhe
蓩	acne
蓪	acep
蓫	agep
蓭	aodn
蓮	alpu
蓯	atwh
蓱	aiua
蓲	aakk
蓳	aakg
蓴	agjf
蓵	argh
蓶	akwy
蓷	arwy
蓸	agmj
蓹	attb
蓺	afwy
蓻	afuy
蓽	ajag
蓾	ahlo
蔀	aukb
蔁	aujj
蔂	alxi
蔃	axkj
蔄	aukf
蔅	auvf
蔆	aift
蔇	avaq
蔈	asfi
蔉	auke
蔊	aojf
蔋	aihc
蔍	aoxx
蔎	aywc
蔏	ayuk
蔐	ayud
蔒	avto
蔔	aqgl
蔕	aaqh
蔖	aheg
蔘	acce
蔙	ayth
蔛	aqef
蔜	agqt
蔝	ahou
蔞	alvf
蔠	axtu
蔢	aibv
蔣	auqf
蔤	apnm
蔥	atln
蔦	aqou
蔧	adhv
蔨	alub
蔩	apgw
蔪	alrj
蔭	abwc
蔮	alag
蔯	absj
蔰	aync
蔱	arsc
蔲	apft
蔳	aige
蔴	aoss
蔵	adah
蔶	agmu
蔾	atqs
蔿	aeto
蕀	asmm
蕁	avaf
蕂	aeue
蕄	aunu
蕅	aijy
蕆	admu
蕇	akkf
蕋	ahhh
蕌	ajjj
蕍	aiwj
蕎	atdk
蕏	aqtj
蕐	agwg
蕑	auef
蕒	almu
蕓	affc
蕔	afuc
蕕	aqtg
蕗	akhk
蕘	affq
蕚	akkn
蕛	atut
蕜	ahdn
蕝	axqc
蕟	awxc
蕠	avki
蕡	afam
蕢	akhm
蕣	aepg
蕥	aahy
蕦	aedm
蕧	attt
蕩	aijr
蕪	atgo
蕫	aujf
蕬	axxi
蕭	avfj
蕮	aeqo
蕯	abtg
蕰	aijl
蕱	atie
蕳	aujf
蕵	aqwv
蕶	afwc
蕷	acnm
蕸	anhp
蕼	advg
蕽	amae
蕿	aoec
薀	aill
薁	atmd
薂	aryt
薃	aiyk
薆	aept
薈	awgj
薉	ahdh
薊	aqoj
薋	auqm
薌	axtb
薍	aecn
薎	alpa
薐	atft
薑	aglg
薒	ahqo
薓	aivc
薔	afwk
薕	aouw
薖	amnp
薗	alfe
薘	afup
薙	atdy
薚	agqr
薝	aqdy
薞	agqv
薟	awgw
薠	aodm
薡	ahnn
薢	aqeg
薣	afkc
薥	alqj
薦	aogo
薧	aypx
薩	abug
薫	atgo
薬	aris
薭	atrf
薱	aouf
薲	apgm
薳	afkp
薴	apns
薵	afnf
薶	aejf
薸	aisi
薺	ayjf
薻	aivs
薼	aoxf
薽	asfy
薾	agwr
薿	axth
藀	aooo
藂	abci
藃	aymw
藄	adwi
藅	alyj
藆	apar
藇	aegw
藈	ahwd
藊	atya
藋	anwy
藌	apnj
藍	aahl
藎	avhl
藑	aqmt
藒	atjn
藔	apdi
藖	aahm
藗	askp
藘	ahln
藙	auec
藚	aflm
藛	apeo
藝	afwc
藞	addd
藟	alll
藠	arrr
藡	ayup
藢	atmt
藣	alcx
藥	arxs
藦	aosr
藧	axec
藨	aoxo
藪	alvt
藫	aisj
藬	abkm
藭	apwx
藮	aswo
藯	anfn
藰	aqyj
藱	aurc
藲	asak
藳	aymt
藴	axjl
藵	awke
藶	adth
藷	ayfj
藸	agej
藹	ayjn
藺	auwy
藼	apdn
藽	ausq
藾	askm
蘀	arlf
蘁	agkk
蘂	anns
蘃	ahhs
蘄	akkr
蘆	ahll
蘇	aqot
蘈	atwm
蘉	alpc
蘊	axll
蘋	ahhm
蘌	atti
蘍	atge
蘎	afec
蘏	axfm
蘐	ayec
蘒	atqn
蘓	atqo
蘔	axtm
蘕	axtp
蘗	anks
蘘	ayke
蘙	aatn
蘚	aqou
蘛	adwe
蘜	aafo
蘝	awgw
蘞	awgt
蘟	aben
蘠	aufk
蘡	ammv
蘢	aued
蘣	aamg
蘤	areo
蘥	awga
蘦	afkk
蘨	aeti
蘪	aoxo
蘫	aial
蘬	atnh
蘭	ausl
蘮	aldj
蘯	aijl
蘰	axjc
蘱	aodm
蘲	allf
蘳	aamf
蘴	amdu
蘵	abyj
蘶	atvc
蘷	adjt
蘹	anye
蘺	ayry
蘻	albi
蘽	alls
蘾	afye
蘿	alxy
虀	ayhg
虁	autt
虂	afkk
虃	aiwg
虄	ajtg
虅	aeuo
虆	alli
虇	axay
虈	akkk
虉	agko
虊	ayxs
虋	aemv
虌	aitx
虒	rhwv
虓	vhwn
處	htwv
虖	htuf
虗	hrd
虘	hegd
虙	hnte
虛	hjng
虜	hlee
虝	hwqr
號	kgnw
虠	urhw
虡	howi
虣	gahw
虤	hwhw
虥	hwaa
虦	aahw
虧	hwyn
虨	hsse
虩	ijiw
虪	hwwo
虭	jvt
虯	jnhh
虰	jsh
虲	jhy
虳	jqyy
虴	jtan
虵	jbn
虶	jgfh
虷	jfh
虸	jbg
蚃	xtju
蚄	jyt
蚅	jdbn
蚆	jcn
蚇	jnyy
蚈	jgah
蚉	yju
蚎	jjg
蚏	jeg
蚐	jqug
蚑	jfcy
蚒	jmyg
蚔	jqan
蚖	jfqn
蚗	jnwy
蚘	jdny
蚙	jwyn
蚚	jrh
蚛	jkhh
蚞	jsy
蚟	jgg
蚠	wvju
蚡	jwvt
蚢	jywn
蚥	jwry
蚦	jmfg
蚫	jqnn
蚭	jnxn
蚮	jway
蚲	jguf
蚳	jqay
蚷	jang
蚸	jryy
蚹	jwfy
蚻	snju
蚼	jqkg
蚽	jdhg
蚾	jby
蚿	jyxy
蛁	jvkg
蛂	jdcy
蛃	jgmw
蛅	jhkg
蛈	jtgy
蛌	jrcy
蛍	ipju
蛒	jtkg
蛓	faji
蛕	jdeg
蛖	jdny
蛗	tnju
蛚	jgqj
蛜	jwvt
蛝	jvy
蛠	jeee
蛡	jng
蛢	juah
蛣	jfkg
蛥	jqqy
蛦	jgxw
蛧	jmrr
蛨	jdjg
蛪	dhvj
蛫	jqdb
蛬	awju
蛯	jftx
蛵	jgva
蛶	jefy
蛷	jgiy
蛺	jdww
蛻	jwkq
蛼	jlh
蛽	jmy
蛿	jwyk
蜁	jtnh
蜄	jdfe
蜅	jsy
蜆	jhqn
蜋	jyvy
蜌	jxxf
蜎	jkeg
蜏	jtbt
蜐	jfce
蜑	thnj
蜔	jqlg
蜖	jljf
蜙	jswc
蜛	jndg
蜝	dwju
蜟	jyce
蜠	jlty
蜤	srju
蜦	jwga
蜧	jynd
蜨	jgvh
蜪	jqtb
蜫	jjxx
蜬	jbib
蜭	jqeg
蜯	jdwg
蜰	ecju
蜲	jtvg
蜳	jybg
蜵	jjgg
蜶	jywf
蜸	ahnj
蜹	jamw
蜺	jeqn
蜼	jwyg
蜽	jgmy
蝀	jsjg
蝁	gfgj
蝂	jthc
蝃	jccc
蝄	jmun
蝅	gdgj
蝆	jhgf
蝊	jpgh
蝋	jiwg
蝍	jvbh
蝏	jyps
蝐	jjhg
蝑	jnhe
蝒	jdlf
蝔	jxxr
蝕	wvjy
蝖	jpgg
蝘	jajv
蝚	jcns
蝛	jdgv
蝜	jqmy
蝝	jxey
蝞	jnhg
蝟	jleg
蝡	jdmd
蝢	jdmy
蝦	jnhc
蝧	jamd
蝨	nfjj
蝩	jtgf
蝪	jjgr
蝫	jftj
蝬	jrbt
蝭	jjgh
蝯	jegc
蝱	ynjj
蝲	jskj
蝳	jgxy
蝵	toju
蝷	jout
蝸	jmnk
蝹	jjlg
蝺	jtky
蝿	jjjn
螀	uqfj
螁	jvpy
螄	jtnh
螆	juxx
螇	jexd
螉	jwcn
螊	juvw
螌	tuwj
螎	jgkh
螏	jutd
螐	jqoy
螑	jthd
螒	fjwj
螔	jrhw
螕	jtlx
螖	jmeg
螘	jmgu
螙	sjju
螚	cexj
螛	jpdk
螜	fpgj
螝	jrqc
螞	jcoy
螠	juwl
螡	yjju
螢	oopj
螣	eugj
螤	yjjw
螥	jwyk
螦	jgxi
螧	jftj
螩	jwhs
螪	jyuk
螮	jaqh
螰	joxx
螱	nfij
螲	jpwf
螴	bsjj
螶	anjj
螷	ortj
螸	wwkj
螹	jlrh
螻	jlvg
螼	jakg
螾	jpgw
螿	uqfj
蟁	najj
蟂	jqsy
蟃	jjlc
蟄	fufj
蟅	joao
蟇	ajdj
蟈	jlag
蟉	jnwe
蟌	jtln
蟍	jtjs
蟎	jamy
蟏	javw
蟐	jiph
蟔	jlfo
蟕	jhxe
蟖	jdwr
蟗	gkhj
蟘	jwam
蟙	jyuj
蟚	fkuj
蟜	jtdk
蟝	jias
蟞	itju
蟟	jdui
蟡	jeto
蟢	jfkk
蟣	jxxw
蟤	jnnw
蟦	jfam
蟧	jooe
蟨	dubj
蟩	jduw
蟫	jsjh
蟬	jkkf
蟭	jwyo
蟯	jffq
蟰	jvfj
蟱	jtgo
蟲	jjju
蟳	jvaf
蟴	dwrj
蟵	jdgf
蟶	jbkg
蟷	jipl
蟸	gejj
蟺	jylg
蟻	jugy
蟼	aqkj
蟽	jfup
蟿	lbwj
蠀	juqm
蠁	xtyj
蠂	jaas
蠄	jwyc
蠅	jxg
蠆	ajmj
蠇	jajy
蠈	madj
蠉	jlge
蠋	jlqj
蠌	jlff
蠍	jjqw
蠎	jada
蠏	jqeg
蠐	jyjg
蠑	joos
蠒	gwmj
蠔	jype
蠗	jnwy
蠘	jfay
蠙	jpgm
蠚	adkj
蠜	srrj
蠝	jlll
蠞	tvbj
蠟	jvln
蠠	dljj
蠣	jday
蠤	usgj
蠥	bttj
蠦	jhll
蠧	fpdj
蠨	javj
蠩	jyfj
蠪	uegj
蠫	ejjj
蠬	jued
蠭	tdhj
蠮	jatn
蠯	ortj
蠰	jyke
蠱	jjjl
蠳	jmmv
蠴	jalj
蠵	jmwk
蠶	aqaj
蠷	jhhy
蠸	jaky
蠺	gdgj
蠻	yxxj
蠽	iwyj
蠾	jnij
蠿	nxxj
衁	yntl
衂	tlvy
衃	tldh
衆	tliu
衇	tlre
衈	tlbg
衉	tltk
衊	tlaw
衋	vgdl
衎	tfgs
衏	tfqs
衐	tans
衑	twys
衒	tyxs
術	tsys
衕	tmgs
衖	taws
衘	ttgs
衚	tdes
衛	tnks
衜	tuts
衝	ttgs
衞	tnks
衟	tvds
衠	tfhs
衦	pufh
衧	pugf
衪	pubn
衭	pugy
衯	puwv
衱	puby
衳	puwc
衴	pupq
衵	pujg
衶	pukh
衸	puwj
衹	puqa
衺	yahe
衻	pumf
衼	pufc
袀	puqu
袃	avye
袆	pufh
袇	pumy
袉	pupx
袊	puwc
袌	yqne
袎	puxe
袏	puda
袐	punt
袑	puvk
袓	pueg
袔	pusk
袕	pupw
袗	puwe
袘	putb
袙	purg
袚	pudy
袛	puqy
袝	puwf
袞	ukeu
袟	putg
袠	ytge
袡	pumf
袣	puan
袥	pudg
袦	pubm
袧	puqk
袨	puyx
袩	puhk
袪	pufc
袬	ycke
袮	puti
袯	puny
袰	xyeu
袲	yqqe
袳	puqq
袴	pudn
袵	puwf
袶	putg
袸	pudb
袹	pudj
袺	pufk
袻	pudj
袽	puvk
袾	putf
袿	puff
裀	puld
裃	puhh
裄	puts
裇	putl
裈	pupl
裊	qyeu
裋	pugu
裌	pudw
裍	puls
裏	yjfe
裐	puke
裑	putt
裓	puaa
裖	pude
裗	puyk
裚	rrye
裛	yceu
補	pusy
裝	ufye
裞	puuq
裠	vtke
裡	pujf
裦	ywfe
裧	puoo
裩	pujx
裪	puqb
裫	pujg
裬	puft
裭	puhw
裮	pujj
裯	pumk
裲	pugy
裵	yhde
裶	puhd
裷	puub
裺	pudn
裻	hice
製	tgme
裿	pudk
褀	pudw
褁	jseu
褃	puhe
褄	pugv
褅	puyh
褆	pujh
複	putt
褈	putf
褉	pudd
褋	puas
褌	pupl
褍	pumj
褎	ywfe
褏	ywfe
褑	puec
褔	pugl
褕	puwj
褖	puxe
褗	puav
褘	pung
褜	eqne
褝	puif
褞	pujl
褟	pujn
褠	puaf
褢	yrqe
褣	pupk
褤	pufe
褦	pucx
褧	boye
褨	puua
褩	tuwe
褬	pucs
褭	ycoe
褮	oope
褯	puoh
褱	ylie
褲	puol
褳	pulp
褵	puyc
褷	puth
褸	pulv
褹	pufy
褺	fufe
褻	yfwe
褼	pusn
褽	nfie
褾	pusi
褿	pugj
襀	pugm
襂	puce
襃	ywfe
襅	pujg
襆	puog
襇	puuj
襈	punw
襉	puue
襊	pujc
襋	pusm
襌	pukf
襍	puws
襎	putl
襏	puwc
襐	puqe
襑	puvf
襒	puit
襓	pufq
襔	puay
襕	puul
襖	putd
襗	pulf
襘	puwj
襙	puks
襚	puup
襛	pume
襜	puqy
襝	puww
襠	puil
襡	pulj
襢	puyg
襣	putj
襤	pual
襥	puwg
襧	pugr
襨	puof
襩	pufm
襪	puaw
襫	pudj
襬	pulx
襭	pufm
襮	puji
襯	puuq
襰	pusm
襱	puud
襲	uege
襳	puwg
襴	puul
襵	pubb
襶	pufw
襷	puer
襸	putm
襹	pugx
襺	puaj
襼	puac
襽	pual
襾	gmbk
覀	sghg
覂	stpu
覄	swdu
覅	svqr
覇	safe
覈	sryt
覉	safk
覊	safo
見	hqb
覌	chqn
覍	ihqb
覎	hqbd
規	ghqn
覐	hqrr
覑	thgq
覒	ehqn
覓	ehqb
覔	dhhq
覕	nthq
視	pyhq
覗	ngkq
覘	hkhq
覙	qihq
覚	iphq
覛	rehq
覜	qihq
覝	fohq
覞	hqhq
覟	fnhq
覠	vtkq
覡	awwq
覢	oohq
覣	tvhq
覤	hwhq
覥	mawq
覦	wgeq
覧	ahnq
覨	kkfq
覩	ftjq
親	ushq
覫	yupq
覬	mgkq
覭	pjuq
覮	oopq
覯	amfq
覰	hegq
覱	lrhq
覲	akgq
観	tgwq
覴	wgkq
覵	uehq
覶	ecmq
覷	hohq
覸	ujhq
覹	hqtt
覺	errq
覻	hgkq
覼	gwmq
覽	ahnq
覾	ptoq
覿	flmq
觀	akkq
觃	mqbd
觍	mawq
觓	qenh
觔	qeet
觕	cqeh
觗	qeqa
觘	qeit
觙	qeby
觛	qejg
觝	qeqy
觟	qeff
觠	ugqe
觡	qetk
觢	dhve
觤	qeqb
觧	qeuh
觨	qeai
觩	qegy
觪	qeuh
觬	qeeq
觭	qedk
觮	qevi
觰	qefj
觱	dgke
觲	qeug
觴	qetr
觵	qeaw
觶	qekf
觷	erre
觸	qelj
觹	qewn
觺	xtde
觻	qers
觼	qeqt
觽	qemn
觾	qeao
觿	qemk
訁	yygg
訂	ysh
訃	yhy
訄	vyd
訅	yvn
訆	ynhh
計	yfh
訉	ywyy
訊	ynfh
訋	yqyy
訌	yag
訍	ycyy
討	yfy
訏	ygfh
訐	yfh
訑	ybn
訒	yvyy
訓	ykh
訔	myf
訕	ymh
訖	ytnn
託	ytan
記	ynn
訙	yvyy
訚	uyd
訛	ywxn
訜	ywvt
訝	yaht
訞	ytdy
訟	ywcy
訠	yxhh
訡	ywyn
訢	yrh
訣	ynwy
訤	yrry
訥	ymwy
訦	ypqn
訧	ydny
訨	yhg
訩	yrbh
訪	yyt
訫	yny
訬	yitt
設	ywcy
訮	ygah
訯	ybyy
訰	ygbn
許	ytfh
訲	ykhh
訳	ynyy
訴	yryy
訵	ylg
訶	yskg
訷	yjhh
訸	yty
訹	ysyy
診	ywet
註	yygg
証	yghg
訽	yqkg
訿	yhxn
詀	yhkg
詁	ydg
詂	ywfy
詃	yyxy
詄	ytgy
詅	ywyc
詆	yqay
詇	ymdy
詉	yvcy
詊	yugh
詋	ykqn
詌	yfg
詍	yann
詎	yang
詏	yxet
詐	ythf
詑	ypxn
詒	yckg
詓	yfcy
詔	yvkg
評	yguf
詖	yby
詗	ymkg
詘	ybmh
詙	ydcy
詚	yjgg
詛	yegg
詜	ybhc
詝	ypsh
詞	yngk
詟	dxyy
詠	yyni
詡	yng
詢	yqjg
詣	yxjg
詤	ywnk
詥	ywgk
試	yaay
詧	wyf
詨	yury
詩	yffy
詪	yvy
詫	ypta
詬	yrgk
詭	yqdb
詮	ywgg
詯	ythg
詰	yfkg
話	ytdg
該	yynw
詳	yuh
詴	ydeg
詵	ytfq
詶	yyth
詷	ymgk
詸	yoy
詺	yqkg
詻	ytkg
詼	ydoy
詽	ygdf
詾	yqrb
詿	yffg
誀	ybg
誁	yuah
誂	yqiy
誃	yqqy
誄	yfsy
誅	ytfy
誆	yagg
誇	ydfn
誈	ygcf
誋	ynny
誌	yfny
認	yvyn
誎	yskg
誏	yyvy
誐	ytry
誑	yqtg
誒	yctd
誔	ytfp
誕	ythp
誖	yfpb
誗	ytjh
誘	ytbt
誙	ygva
誚	yieg
誛	yvpc
誜	ycwt
誝	ywyk
語	ygkg
誟	yftb
誠	ydnn
誡	yaah
誢	yhqn
誣	yaww
誤	ykgd
誥	ytfk
誦	yceh
誧	ysy
誨	ytxy
誩	yyg
說	ywkq
誫	ydfe
説	yukq
読	yfpq
誮	yawx
誯	yjjg
誰	ywyg
誱	ygvh
課	yjsy
誳	ynbm
誴	ypfi
誵	yrde
誶	yywf
誷	ymun
誸	yxyx
誹	yhdd
誺	ysww
誻	yijg
誼	ypeg
誽	yeqn
誾	uyd
調	ymfk
諀	yrtf
諁	yccc
諂	yqeg
諃	yssy
諄	yybg
諅	dwyf
諆	ydwy
談	yooy
諈	ytgf
諉	ytvg
諊	yqoy
請	ygeg
諌	ysjg
諍	yqvh
諎	yajg
諏	ybcy
諐	wkky
諑	ygey
諒	yyiy
諓	yaay
諔	yhic
諕	yhwn
論	ywga
諗	ywyn
諘	ygey
諙	yqaj
諚	ypgh
諛	yewy
諜	yans
諝	ynhe
諞	yyna
諟	yjgh
諠	ypgg
諡	ywgl
諢	yplh
諣	ymnk
諤	ykkn
諥	ytgf
諦	yyuh
諧	yxxr
諨	ygkl
諩	yuog
諪	yyps
諫	yslg
諬	tdny
諭	ywgj
諮	yuqk
諯	ymdj
諰	ylny
諱	ynkg
諲	ysfg
諳	yujg
諴	ydgk
諵	yfmf
諶	ydwn
諷	ywtj
諸	yftj
諹	yjgr
諺	yute
諻	yrgg
諼	yegc
諽	yafh
諾	yadk
諿	ykbg
謀	yfsy
謁	yjqn
謂	yleg
謃	yjtg
謄	eugy
謅	yqbt
謆	yynn
謈	jawy
謉	yrqc
謊	yayk
謋	yqgs
謌	yskk
謍	oopy
謎	yopy
謏	yehc
謐	yntl
謑	yexd
謒	ywyk
謓	yfhw
謔	yhag
謕	yrhw
謖	ylwt
謗	yyuy
謘	ynuh
謙	yuvw
謚	yuwl
講	yamf
謜	ydri
謝	ytmf
謞	yymk
謟	yeeg
謠	yqtb
謡	yetb
謢	ywyc
謣	yffn
謤	ysfi
謥	ytln
謧	yyrc
謨	yajd
謩	ajdy
謪	yyuk
謫	yyud
謬	ynwe
謭	yuev
謮	ygmy
謯	yheg
謰	ylpy
謱	ylvg
謲	ycce
謳	yakk
謴	yxmy
謵	ynrg
謶	yoao
謷	gqty
謸	ygqt
謹	yakg
謺	fufy
謻	ytqq
謼	yhtf
謽	xkjy
謾	yjlc
謿	yfje
譀	ynbt
譁	yagg
譂	ykkf
譃	yhog
譄	yulj
譅	yvyh
譆	yfkk
譇	ydfj
譈	yybt
證	ywgu
譊	yffq
譋	yueg
譌	yeto
譍	owwy
譎	ycnk
譏	yxxw
譐	yusf
譑	ytdk
譒	ytol
譓	ygjn
譔	ynnw
譕	ytgo
譖	yaqj
譗	ytwk
識	yyuj
譙	ywyo
譚	ysjh
譛	yggj
譜	yuoj
譝	yxg
譞	ylge
譟	ykks
譠	yylg
譡	yipl
譢	yuep
譣	ywgw
譤	yryt
譥	ryty
譧	youw
譨	ymae
譩	yujn
譪	yajn
譫	yqdy
譭	yeac
譮	ywgj
譯	ylff
議	yugy
譱	uyyd
譲	yuae
譳	yfdj
譴	ykhp
譵	youf
譶	yyyf
護	yawc
譸	yfnf
譹	yype
譺	yxth
譻	mmyf
譼	ahny
譽	egny
譾	yuen
譿	ydhn
讀	yflm
讁	yyup
讂	yqmt
讃	yggm
讄	ylll
讅	yptl
讆	tnky
讇	yuqe
讈	ydth
讉	ykhp
變	yxxt
讋	uegy
讌	yako
讍	ygkk
讎	wyyy
讏	tnky
讐	wywy
讑	ywga
讒	yqky
讓	yyke
讔	yben
讕	yusl
讖	ywwg
讗	ymwk
讘	ybbb
讙	yaky
讚	ytfm
讛	yafc
讜	yipo
讝	ykkt
讞	yhgd
讟	yfly
讬	ytan
讱	yvyy
讻	yrbh
诇	ymkg
诐	yby
诪	ydtf
谉	ypjh
谞	ynhe
谸	tdwk
谹	wwkc
谺	wwkt
谻	wwkg
谼	wwkw
谽	wwkk
谾	wwka
谿	exdk
豀	wwkd
豂	wwke
豃	wwkt
豄	wwkm
豅	wwkd
豈	mgku
豊	magu
豋	wgku
豍	gkuf
豎	ahnu
豏	gkuw
豐	mdhu
豑	magt
豒	mdht
豓	mdhl
豔	mdhl
豖	geyi
豗	gqge
豘	gegn
豙	ueu
豛	gewc
豜	gega
豝	gecn
豞	geqk
豟	geyn
豠	geeg
豣	gegf
豤	gevy
豥	geyw
豦	hgei
豧	gesy
豨	gerh
豩	gege
豬	gefj
豭	genc
豮	gefm
豯	geed
豰	fpfc
豱	gejl
豲	gedi
豴	geyd
豵	geth
豶	gefm
豷	gefu
豻	efh
豼	exxn
豽	emwy
豾	edhg
豿	eqkg
貀	ebmh
貁	epwy
貃	erg
貄	evgh
貆	egjg
貇	evy
貈	etuy
貋	ejfh
貍	ejfg
貎	eeqn
貏	ertf
貐	ewgj
貑	enhc
貒	emdj
貓	ealg
貕	eexd
貖	euwl
貗	elvg
貙	eakk
貚	ekkf
貛	eaky
貜	ehhc
貝	mhny
貞	hmu
貟	cmu
負	qmu
財	mftt
貢	amu
貣	aymu
貤	mbn
貥	mywn
貦	mfqn
貧	wvmu
貨	wxmu
販	mrcy
貪	wynm
貫	xmu
責	gmu
貭	rfmi
貮	gamy
貯	mpsh
貰	anmu
貱	mby
貲	hxmu
貳	afmy
貴	khgm
貵	cdmu
貶	mtpy
買	lmu
貸	waym
貹	mtgg
貺	mkqn
費	xjmu
貼	mhkg
貽	mckg
貾	mqay
貿	qyvm
賀	ekmu
賁	famu
賂	mtkg
賃	wtfm
賄	mdeg
賅	mynw
賆	muah
資	uqwm
賈	smu
賉	mtlg
賊	madt
賋	mury
賌	yntm
賍	mofg
賎	mfay
賏	mmy
賐	mcwt
賑	mdfe
賒	mwfi
賓	pghm
賔	pnmu
賕	mgiy
賖	mwgs
賗	mkkh
賘	mofy
賙	mmfk
賚	swwm
賛	ggmu
賜	mjqr
賝	mpws
賞	ipkm
賟	mmaw
賠	mukg
賡	ovwm
賢	ahnm
賣	flmu
賤	maay
賥	mywf
賦	mgay
賧	mooy
賨	pfim
賩	mpfi
質	rrmu
賫	fwwm
賬	mdey
賭	mftj
賮	vhgm
賯	mqjb
賰	mdwj
賱	mplh
賲	wksm
賳	mfak
賴	skqm
賵	mjhg
賶	mwyk
賷	fkkm
賸	eugm
賹	muwl
賺	muvw
賻	msfy
購	mamf
賽	pawm
賾	ahkm
賿	mnwe
贀	atdm
贁	mmty
贂	mcce
贃	mkkn
贄	fufm
贅	gqtm
贆	mddd
贇	ygam
贈	mulj
贉	msjh
贊	tfqm
贋	dwwm
贌	moug
贍	mqdy
贎	majy
贏	yemy
贐	mvhl
贑	ujam
贒	ahnm
贓	mauh
贔	mmmu
贕	qytm
贖	mflm
贗	dwqm
贘	mipm
贙	hwhm
贚	mued
贛	ujtm
贜	maah
贠	cmu
赑	mmmu
赒	mmfk
赗	mjhg
赟	ygam
赥	foqw
赨	fojy
赩	foqc
赪	fohm
赬	fohm
赮	fonc
赯	fook
赱	fuyu
赲	fhee
赸	fhmk
赹	fhqu
赺	fhwn
赻	fhit
赼	fhqw
赽	fhnw
赾	fhrk
赿	fhqa
趀	fhtt
趂	fhqi
趃	fhtg
趆	fhqy
趇	fhud
趈	fhhk
趉	fhbm
趌	fhfk
趍	fhqq
趎	fhtf
趏	fhtd
趐	fhnd
趒	fhqi
趓	fhws
趕	fhjf
趖	fhwf
趗	fhkh
趘	fhne
趙	fhie
趚	fhsk
趛	fhqd
趜	fhqo
趝	fhwn
趞	fhaj
趠	fhhj
趡	fhwy
趢	fhvi
趤	fhpd
趥	fhug
趦	fhuk
趧	fhjh
趨	fhqt
趩	fhlw
趪	fhaw
趫	fhtk
趬	fhfq
趭	fhwo
趮	fhks
趯	fhny
趰	fhgr
趲	fhtm
趶	khgf
趷	khtn
趹	khnw
趻	khwn
趽	khyt
跀	kheg
跁	khcn
跂	khfc
跅	khry
跇	khan
跈	khwe
跉	khwc
跊	khfy
跍	khdg
跐	khhx
跒	khsk
跓	khyg
跔	khqk
跕	khhk
跘	khug
跙	kheg
跜	khnx
跠	khgw
跡	khyo
跢	khqq
跥	khbs
跦	khtf
跧	khwg
跩	khjt
跭	khtg
跮	khgf
跰	khua
跱	khff
跲	khwk
跴	khsg
跶	khdp
跼	khnk
跾	whth
跿	khfh
踀	khkh
踁	khga
踂	khbn
踃	khie
踄	khhh
踆	khct
踇	khtx
踈	khsk
踋	khfb
踍	khfb
踎	khdk
踐	khaa
踑	khdw
踒	khtv
踓	khwy
踕	khgh
踖	khaj
踗	khwn
踘	khqo
踙	khbc
踚	khwa
踛	khff
踜	khft
踠	khpb
踡	khub
踤	khyf
踥	khuv
踦	khdk
踧	khhc
踨	khwh
踫	khuo
踭	khqh
踰	khwj
踲	khrh
踳	khdj
踴	khce
踶	khjh
踷	khfj
踸	khdn
踻	khmk
踼	khjr
踾	khgl
踿	khto
蹃	khak
蹅	khsg
蹆	khvp
蹌	khwk
蹍	khne
蹎	khfw
蹏	khrw
蹐	khie
蹓	khql
蹔	lrkh
蹕	khjg
蹖	khde
蹗	khox
蹘	khne
蹚	khif
蹛	khah
蹜	khpj
蹝	khth
蹞	khxm
蹟	khgm
蹠	khoo
蹡	khuf
蹢	khyd
蹣	khay
蹤	khth
蹥	khlp
蹧	khgj
蹨	khqo
蹪	khkm
蹫	khck
蹮	khsn
蹱	khuf
蹳	khwc
蹵	yidh
蹷	dubh
蹸	khog
蹹	khwn
蹺	khfq
蹻	khtk
蹽	khdi
蹾	khyt
躀	khxm
躂	khfp
躃	khnu
躄	nkuh
躆	khhe
躈	khrt
躉	ajmh
躊	khff
躋	khyj
躌	khtg
躍	khny
躎	khgr
躑	khub
躒	khrs
躓	khrm
躕	khof
躖	khxh
躗	tnkh
躘	khud
躙	khuy
躚	khsp
躛	tnkh
躝	khul
躟	khye
躠	atnh
躡	khbb
躢	khun
躣	khhy
躤	khaj
躥	khpn
躦	khtm
躧	khgx
躨	khut
躩	khhc
躪	khay
躭	tmdq
躮	tmdv
躰	tmdg
躱	tmds
躳	tmdk
躴	tmdv
躵	tmdn
躶	tmds
躷	tmdv
躸	tmdk
躹	tmdo
躻	tmda
躼	tmde
躽	tmdv
躾	tmdd
躿	tmdi
軀	tmdk
軁	tmdv
軂	tmde
軃	tmdf
軄	tmdj
軅	tmdy
軆	tmdu
軇	tmdf
軈	tmdn
軉	tmdm
車	lghh
軋	lnn
軌	lvn
軍	plj
軏	lgqn
軐	lnfh
軑	ldy
軒	lfh
軓	lwyy
軔	lvyy
軕	lmh
軖	lgg
軗	lwcy
軘	lgbn
軙	lhcy
軚	ldyy
軛	ldbn
軜	lmwy
軝	lqan
軞	len
軟	lqwy
軠	ltfg
軡	lwyn
転	lfcy
軣	liu
軤	ltuf
軥	lqkg
軦	lkqn
軧	lqay
軨	lwyc
軩	lckg
軪	lxet
軫	lwet
軬	cdlj
軭	lagg
軮	lmdy
軯	lguf
軰	uxlj
軱	lrcy
軲	ldg
軳	lqnn
軴	lygg
軵	lwfy
軶	lynn
軷	ldcy
軸	lmg
軹	lkwy
軺	lvkg
軻	lskg
軼	ltgy
軽	lcfg
軾	laay
軿	luah
輀	ldmj
輁	lawy
輂	awlj
較	lury
輄	ligq
輅	ltkg
輆	lynw
輇	lwgg
輈	ltuy
載	falk
輊	lgcf
輋	mdlj
輌	lgmm
輍	lwwk
輎	lieg
輏	lsgg
輐	lpfq
輑	lvtk
輒	lbnn
輓	lqkq
輔	lsy
輕	lgva
輖	lmfk
輗	leqn
輘	lfwt
輙	lbcy
輚	laay
輛	lgmy
輜	lvlg
輝	igql
輞	lmun
輟	lccc
輠	ljsy
輡	lqeg
輢	ldsk
輣	leeg
輤	lgeg
輥	ljxx
輦	gglj
輧	ltgf
輨	lpng
輩	hdhl
輪	lwga
輫	lhdd
輬	lyiy
輭	ldmd
輮	lcns
輯	lkbg
輰	ljgr
輱	ldgk
輲	lmdj
輳	ldwd
輴	lrfh
輵	ljqn
輶	lusg
輷	lqyg
輸	lwgj
輹	ltjt
輺	lvgl
輻	lgkl
輼	ljlg
輽	lcdl
輾	lnae
輿	elgw
轀	llwl
轁	leeg
轂	fpgc
轃	ldwt
轄	lpdk
轅	lfke
轆	loxx
轇	lnwe
轈	lvjs
轉	lgjf
轊	ldhv
轋	llpy
轌	lfvg
轍	lyct
轎	ltdk
轏	lnbb
轐	loug
轑	ldui
轒	lfam
轓	ltol
轔	loqg
轕	lajn
轖	lfwk
轗	ldgn
轘	llge
轙	lugy
轚	lbwl
轛	louf
轜	lfdj
轝	egnl
轞	lahl
轟	lllj
轠	llll
轡	xlxk
轢	lrxs
轣	ldth
轤	lhll
轥	lauy
轪	ldy
辀	ltuy
辌	lyiy
辒	ljlg
辝	ckuh
辠	thuj
辡	uuh
辢	skuh
辤	epcu
辥	bttu
辦	ueuh
辧	uvuh
辪	htnu
辬	uyuh
辭	ecmu
辮	uxiu
辯	uyuh
農	made
辳	ssde
辴	kkje
辵	ehu
辷	gpd
辸	bpe
辺	vpe
辻	fpk
込	typi
辿	mpk
迀	fpk
迃	fnpv
迆	bpv
迉	npe
迊	gmhp
迋	gpd
迌	epd
迍	gbnp
迏	dypi
迒	ywpv
迖	dpi
迗	gdpi
迚	khpk
迠	hkpd
迡	nxpv
迣	anpv
迧	jhpk
迬	ygpd
迯	qhpi
迱	pxpv
迲	fcpi
迴	lkpd
迵	mgkp
迶	depd
迺	spd
迻	qqpi
迼	fkpd
迾	gqjp
迿	qjpd
逇	fbpv
逈	tmkp
逌	hlnp
逎	sgpd
逓	rfmp
逕	gvap
逘	ctdp
這	ypd
逜	gkpd
連	lpk
逤	iitp
逥	ljfp
逧	wwkp
逨	swwp
逩	dfap
逪	ajpd
逫	cccp
逬	tgdp
逰	rtbp
週	mfkp
進	wypd
逳	ycep
逴	hjpk
逷	jqrp
逹	fufp
逺	fnep
逽	adkp
逿	jgqp
遀	daep
遃	utep
遅	nupk
遆	yupp
遈	jghp
遉	hmpi
遊	ytbp
運	plpk
遌	kkfp
過	mnmp
達	fupk
違	nkgp
遖	fmup
遙	qtfp
遚	ehcp
遜	btxp
遝	lipi
遞	rhwp
遟	nupk
遠	fkep
遡	ubtp
遤	copi
遦	xmpi
遧	ujpk
適	yump
遪	cccp
遫	sktp
遬	skqp
遯	egep
遰	aqpp
遱	lvpd
遲	nitp
遳	awwp
遶	fffp
遷	sdnp
選	nnap
遹	cnhp
遺	khgp
遻	kkup
遼	dujp
遾	tawp
邁	ajmp
還	lgkp
邅	ylkp
邆	wgkp
邇	gwmp
邉	thpp
邊	thpp
邌	tqtp
邍	tlvp
邎	qytp
邏	lxwp
邐	gmyp
邒	sbh
邔	nbh
邖	mbh
邘	gfbh
邚	vbh
邜	qbh
邞	gbh
邟	ywbh
邠	wvbh
邤	rbh
邥	pqbh
邧	fqbh
邨	gbnb
邩	obh
邫	dtkc
邭	qkbh
邲	ntbh
邷	gnnb
邼	agbh
邽	ffbh
邿	ffbh
郀	dfnb
郂	yntb
郃	wgkb
郆	fkbh
郈	rgkb
郉	gdfb
郋	thbh
郌	ffkc
郍	tubh
郒	yvkc
郔	thnb
郕	dnbh
郖	gkub
郘	kkbh
郙	sbh
郚	gkbh
郞	yvbh
郟	dwwb
郠	gjrb
郣	fpbb
郤	wwkb
郥	mbh
郩	rdeb
郪	gvhb
郬	gebh
郮	mfkb
郰	bcbh
郱	uabh
郲	swwb
郳	eqbh
郵	tgab
郶	ukkc
郷	xtvb
郹	hdbh
郺	qqvc
郻	hnvb
郼	nkgb
郿	nhbh
鄀	adkb
鄁	uxeb
鄃	wgeb
鄅	tkmb
鄆	plbh
鄇	wntb
鄈	wgdb
鄉	xtyb
鄊	xtbb
鄋	ehcb
鄌	ovhb
鄍	pjub
鄎	thnb
鄏	dfeb
鄐	yxlb
鄑	gojb
鄒	qbtb
鄓	thdb
鄔	qobh
鄕	xtrb
鄖	kmbh
鄗	ymkb
鄘	oveb
鄚	ajdb
鄛	vjsb
鄜	oxxb
鄝	nweb
鄟	gjhb
鄠	ffnb
鄡	qsbh
鄤	jlcb
鄥	qobh
鄦	tglb
鄧	wgkb
鄨	itkc
鄩	vakb
鄪	xjmb
鄫	uljb
鄬	etnb
鄭	usgb
鄮	qyvb
鄰	oqgb
鄲	kkjb
鄳	xbh
鄴	oufb
鄵	kkkb
鄶	wglb
鄷	magb
鄸	alpb
鄺	oamb
鄻	gglb
鄼	ggmb
鄽	ojfb
鄾	depb
鄿	akkb
酀	akub
酁	qkxb
酂	tfqb
酄	akkb
酅	mwyb
酇	tfqb
酈	gmyb
酑	sggf
酓	wyng
酔	sgvf
酕	sgen
酖	sgpq
酘	sgwc
酙	sguf
酛	sgfq
酜	sggy
酟	sghk
酠	sgsk
酦	sgny
酧	sgpf
酨	fasg
酫	sgwg
酭	sgde
酳	sgxe
酺	sgsy
酻	sgeb
酼	sgyk
醀	sgwy
醁	sgvi
醂	sgss
醃	sgdn
醄	sgqb
醆	sgaa
醈	sgoo
醊	sgcc
醎	sgdk
醏	sgfj
醓	sgpl
醔	tosg
醕	sgyj
醖	sgjl
醗	sgwq
醘	sgfl
醙	sgec
醜	sgrc
醝	sgua
醞	sgll
醟	oopg
醠	sgml
醡	sgpf
醤	uefg
醥	sgsi
醦	sgce
醧	sgak
醨	sgyc
醩	sggj
醫	atdg
醬	uqfg
醰	sgsj
醱	sgwc
醲	sgme
醳	sglf
醶	sgww
醷	sgun
醸	sgue
醹	sgfj
醻	sgff
醼	sgao
醽	sgfk
醾	sgoo
醿	sgoi
釀	sgye
釁	emgv
釂	sgef
釃	sggx
釄	sgod
釅	sgkt
釆	toi
釈	tony
釋	tolf
釐	ftdf
釒	qtyg
釓	qnn
釔	qnn
釕	qbh
釖	qvt
釗	qjh
釘	qsh
釙	qhy
釚	qvn
釛	qet
針	qfh
釞	qtyy
釟	qwy
釠	qwn
釡	wqf
釢	qbt
釣	qqyy
釤	qet
釥	qiy
釦	qkg
釧	qkh
釨	qbg
釩	qwyy
釪	qgfh
釫	qfnn
釬	qfh
釭	qag
釮	qftt
釯	qynn
釰	qvyy
釱	qdy
釲	qnn
釳	qtnn
釴	qayy
釵	qcyy
釶	qbn
釷	qfg
釸	qqy
釹	qvg
釺	qtfh
釻	qvyy
釼	qvyy
釽	qrhy
釾	qaht
釿	qrh
鈀	qcn
鈁	qyt
鈂	qpqn
鈃	qgah
鈄	qufh
鈅	qeg
鈆	qwcy
鈇	qgy
鈈	qdhy
鈉	qmwy
鈊	qny
鈋	qwxn
鈌	qnwy
鈍	qgbn
鈎	qqcy
鈏	qxhh
鈐	qwyn
鈑	qrcy
鈒	qbyy
鈓	qtfg
鈔	qitt
鈕	qnhg
鈖	qwvt
鈗	qcqn
鈘	qfcy
鈙	qhcy
鈚	qxxn
鈛	qay
鈜	qdcy
鈝	qtgh
鈞	qqug
鈟	qxhh
鈠	qwcy
鈡	qkhh
鈢	qsy
鈣	qghn
鈤	qjg
鈥	qoy
鈦	qdyy
鈧	qywn
鈨	qfqn
鈩	qynt
鈪	qdbn
鈫	qyy
鈬	qnyy
鈭	hxqf
鈮	qnxn
鈯	qbmh
鈰	qymh
鈱	qnan
鈲	qrcy
鈳	qskg
鈴	qwyc
鈵	qgmw
鈶	qckg
鈷	qdg
鈸	qdcy
鈹	qby
鈺	qgyy
鈻	qng
鈼	qthf
鈽	qdmh
鈾	qmg
鈿	qlg
鉀	qlh
鉁	qwet
鉂	qkry
鉃	qtdy
鉄	qtgy
鉅	qang
鉆	qhkg
鉇	qtbn
鉈	qpxn
鉉	qyxy
鉊	qvkg
鉋	qqnn
鉌	qty
鉍	qntt
鉎	qtgg
鉏	qegg
鉐	qdg
鉑	qrg
鉒	qygg
鉓	qtmh
鉔	qamh
鉕	qakg
鉖	qtuy
鉗	qfg
鉘	qxjh
鉙	qkwy
鉚	qqtb
鉛	qwkg
鉜	qwfy
鉝	qug
鉞	qann
鉟	qdhg
鉠	qmdy
鉡	qugh
鉢	qsgg
鉣	qfcy
鉤	qqkg
鉥	qsyy
鉦	qghg
鉧	qxy
鉨	qqiy
鉩	qwiy
鉪	qann
鉫	qekg
鉬	qhg
鉭	qjgg
鉮	qjhh
鉯	qnyw
鉰	qngk
鉱	qocy
鉲	qhhy
鉳	quxn
鉵	qjy
鉶	qgaj
鉷	qawy
鉸	qury
鉹	qqqy
鉺	qbg
鉻	qtkg
鉼	quah
鉽	qaay
鉾	qctg
鉿	qwgk
銀	qvy
銁	qqjg
銂	qyth
銃	qycq
銄	qtmk
銅	qmgk
銆	qdjg
銇	qfsy
銈	qffg
銉	qvgh
銊	qdgg
銋	qwtf
銌	qdhb
銍	qgcf
銏	qmmg
銐	gqjq
銑	qtfq
銒	qgdf
銓	qwgg
銔	qdhf
銕	qgxw
銖	qtfy
銗	qrgk
銘	qqkg
銙	qdfn
銚	qqiy
銛	qtdg
銜	tqgs
銝	qwsy
銞	qjqf
銟	qmmh
銠	qftx
銡	qfkg
銢	qfiy
銣	qvkg
銤	qoy
銥	qyey
銦	qldy
銧	qigq
銨	qpvg
銩	qtfc
銪	qdeg
銫	qqcn
銬	qftn
銭	qfay
銯	qxiy
銰	qary
銱	qkmh
銲	qjfh
銳	qwkq
銴	rrqf
銵	qtmt
銶	qgiy
銷	qieg
銸	qbnn
銹	qtbt
銺	ufqf
銻	quxt
銼	qwwf
銽	qqak
銾	qaiy
銿	qceh
鋀	qgku
鋁	qkkg
鋂	qtxy
鋃	qyvy
鋄	qgoc
鋅	quh
鋆	fquq
鋇	qmy
鋉	qskg
鋊	qwwk
鋋	qthp
鋌	qtfp
鋍	qfpb
鋎	qpfq
鋏	qdww
鋐	qpdc
鋑	qcwt
鋒	qtdh
鋓	qtjh
鋔	qqkq
鋕	qfny
鋖	qevg
鋗	qkeg
鋘	qkgd
鋙	qgkg
鋚	whtq
鋛	qkkh
鋜	qkhy
鋝	qefy
鋞	qgva
鋟	qvpc
鋠	qdfe
鋡	qwyk
鋢	qebg
鋣	qahb
鋤	qege
鋥	qkgg
鋦	qnnk
鋧	qhqn
鋨	qtry
鋩	qayn
鋪	qsy
鋫	tjqf
鋬	rrcq
鋭	qukq
鋮	qdnn
鋯	qtfk
鋰	qjfg
鋱	qany
鋲	qrwy
鋳	qdtf
鋴	qdqn
鋵	qtwn
鋶	qyck
鋷	qbcy
鋸	qndg
鋹	qdey
鋺	qpqb
鋻	ahnq
鋼	qmum
鋽	qhjh
鋾	qqtb
鋿	qimk
錀	qwga
錁	qjsy
錂	qfwt
錃	ibqf
錄	qxiy
錅	tqtq
錆	qgeg
錇	qukg
錈	qugb
錉	qqaj
錊	qywf
錋	qeeg
錌	qmdf
錍	qrtf
錎	qqeg
錏	qgfg
錐	qwyg
錑	qynd
錒	qbsk
錓	qunn
錔	qijg
錕	qjxx
錖	hicq
錗	qtvg
錘	qtgf
錙	qvlg
錚	qqvh
錛	qdfa
錜	qwyn
錝	qpfi
錞	qybg
錟	qooy
錠	qpgh
錡	qdsk
錢	qaay
錣	qccc
錤	qdwy
錥	qyce
錦	qrmh
錧	qpng
錨	qalg
錩	qjjg
錪	qmaw
錫	qjqr
錬	qsjg
錭	qmfk
錮	qldg
錯	qajg
錰	qsoy
錱	qggf
録	qviy
錳	qblg
錴	qfwf
錵	qawx
錶	qgey
錷	qlnn
錸	qsww
錹	qheg
錺	qayt
錻	qgay
錼	qdfi
錽	qgot
錿	qhwn
鍀	qjgf
鍁	qrqw
鍂	qqg
鍃	qqrn
鍄	qyiy
鍅	qifc
鍆	qug
鍇	qxxr
鍈	qamd
鍉	qjgh
鍊	qslg
鍋	qmnk
鍌	itfq
鍍	qoac
鍎	qrfh
鍏	qnkg
鍐	qrbt
鍑	qtjt
鍒	qcns
鍓	qkbg
鍔	qkkn
鍕	qplh
鍖	qdwn
鍗	qyuh
鍘	qmjh
鍙	iawq
鍚	qjgr
鍛	qthc
鍜	qnhc
鍝	qjmy
鍞	qhmy
鍟	qjtg
鍠	qrgg
鍡	qlge
鍢	qgkl
鍣	qavk
鍤	qtfe
鍥	qdhd
鍦	qytb
鍧	qqyg
鍨	qwgd
鍩	qadk
鍫	toqf
鍬	qtoy
鍭	qwnd
鍮	qwgj
鍯	qqrn
鍰	qegc
鍱	qans
鍲	qnaj
鍳	ahnq
鍴	qmdj
鍵	qvgp
鍶	qlny
鍷	qdff
鍸	qdeg
鍹	qpgg
鍺	qftj
鍻	qjqn
鍼	qdgk
鍽	qyna
鍾	qtgf
鍿	qvgl
鎀	qwhe
鎁	qbbh
鎂	qugd
鎃	qire
鎄	qyey
鎅	qlwj
鎆	quej
鎇	qnhg
鎈	quag
鎉	qjng
鎊	qyuy
鎋	qpdk
鎌	quvw
鎍	qfpi
鎎	qroy
鎐	qetb
鎑	qfcl
鎒	qdff
鎓	qwcn
鎔	qpwk
鎕	qovk
鎖	qimy
鎗	qwyk
鎘	qgkh
鎙	qube
鎚	qtnp
鎛	qsfy
鎜	tuwq
鎝	qawk
鎞	qtlx
鎟	qccs
鎠	qlgh
鎡	quxx
鎢	qqoy
鎣	oopq
鎤	qjiq
鎥	whtq
鎦	qqyl
鎧	qmgu
鎨	qwyf
鎩	qrsc
鎪	qehc
鎫	qtmt
鎬	qymk
鎭	qxhw
鎮	qfhw
鎯	qyvb
鎰	quwl
鎱	qfke
鎲	qipq
鎳	qths
鎴	qthn
鎵	qpge
鎶	qskk
鎷	qcoy
鎸	qwyb
鎹	qudp
鎺	qpyg
鎻	qvmy
鎼	qhrh
鎽	qmth
鎾	qjlg
鎿	qwgr
鏀	qhlo
鏁	qvjs
鏂	qakk
鏃	qytd
鏄	qgjf
鏅	qwhe
鏆	qxmy
鏇	qyth
鏈	qlpy
鏉	qskw
鏋	qamy
鏌	qajd
鏍	qlxi
鏎	qjag
鏏	qdhv
鏐	qnwe
鏑	qyud
鏒	qcce
鏓	qtln
鏔	qpgw
鏕	qoxx
鏗	qahf
鏘	quqf
鏙	qmwy
鏚	qdhi
鏛	qiph
鏜	qipf
鏝	qjlc
鏞	qovh
鏟	qutg
鏠	qtdp
鏡	qujq
鏢	qsfi
鏣	qoao
鏤	qlvg
鏥	qpwj
鏦	qtwh
鏧	fnwq
鏨	lrqf
鏩	qlrh
鏪	qgmj
鏫	qtjs
鏬	qhtf
鏭	qton
鏮	qovi
鏯	qdrr
鏰	qmee
鏱	qujh
鏲	qyxg
鏳	qulj
鏴	qkhk
鏵	qagg
鏶	qwys
鏷	qoug
鏸	qgjn
鏹	qxkj
鏺	qwxc
鏻	qoqg
鏼	qtsm
鏽	qvfj
鏾	qaet
鏿	qips
鐀	qkhm
鐁	qdwr
鐂	qgjl
鐃	qffq
鐄	qamw
鐅	itqf
鐆	bueq
鐇	qtol
鐈	qtdk
鐉	qnnw
鐊	qbjr
鐋	qijr
鐌	qqke
鐍	qcnk
鐎	qwyo
鐏	qusf
鐐	qdui
鐑	qxfk
鐒	qooe
鐓	qybt
鐔	qsjh
鐕	qaqj
鐖	qxxw
鐗	queg
鐘	qujf
鐙	qwgu
鐚	qgfn
鐛	qjyi
鐜	ybtq
鐝	qduw
鐞	qvaf
鐟	qggj
鐠	quoj
鐡	qfau
鐢	srrq
鐣	qipr
鐤	qhnn
鐥	quuk
鐦	quga
鐧	qujg
鐨	qxjm
鐩	quep
鐪	qhle
鐫	qwyn
鐬	qhdh
鐭	qtmd
鐮	qouw
鐯	qafj
鐰	qkks
鐱	qwgw
鐲	qlqj
鐳	qflg
鐴	qnku
鐵	qfag
鐶	qlge
鐷	qaas
鐸	qlff
鐹	qmnp
鐺	qipl
鐻	qhge
鐼	qfam
鐽	qfup
鐿	qujn
鑀	qept
鑁	qobt
鑂	qtgo
鑃	qnwy
鑄	qfnf
鑅	qoos
鑆	qouf
鑇	qyjg
鑈	qgwr
鑉	qafl
鑊	qawc
鑋	lgvq
鑌	qpgm
鑍	mmqf
鑎	qakm
鑏	qpns
鑐	qfdj
鑑	qahl
鑒	ahnq
鑓	qkhp
鑔	qpwi
鑕	qrrm
鑖	qalw
鑗	qtqi
鑘	qlll
鑙	qtdj
鑚	qggm
鑛	qoaw
鑜	qipm
鑝	qatp
鑞	qvln
鑟	qflm
鑠	qrxs
鑡	qhbh
鑢	qhln
鑣	qoxo
鑤	qjai
鑥	qqoj
鑦	qahm
鑧	qpay
鑨	qued
鑩	qgkk
鑪	qhll
鑬	qahq
鑭	qusl
鑮	qaif
鑯	qwwg
鑰	qwga
鑱	qqky
鑲	qyke
鑳	qpah
鑴	qmwk
鑵	qaky
鑶	qaah
鑷	qbbb
鑸	qllf
鑹	qpwn
鑺	qhhy
鑻	qsrr
鑼	qlxy
鑽	qtfm
鑾	yxxq
鑿	oufq
钀	qhgd
钁	qhhc
钂	qipo
钃	qnij
钄	qaul
钑	qbyy
钖	qnrt
钘	qgah
铇	qqnn
铏	qgaj
铓	qayn
铔	qgog
铚	qgcf
铦	qtdg
铻	qgkg
锜	qdsk
锠	qjjg
锧	qrfm
锳	qamd
锽	qrgg
镃	quxx
镈	qsfy
镋	qipq
镕	qpwk
镚	qmee
镠	qnwe
镮	qlge
镴	qvln
镵	qqky
長	deu
镸	dghy
镹	dqyy
镺	dtdy
镻	dtgy
镼	dnbm
镽	ddui
镾	dgwr
門	uhng
閁	ute
閂	ugd
閃	uwi
閄	uwy
閅	usk
閆	udd
閇	ughi
閈	ufk
閉	ufte
閊	umk
開	ugak
閌	uywv
閍	uye
閎	udci
閏	ugd
閐	uev
閑	usi
閒	ued
間	ujd
閔	uyi
閕	uaht
閖	uii
閗	uufk
閘	ulk
閙	uymh
閚	uud
閛	uguf
閜	uskd
閝	uwyc
閞	ucak
閟	unte
閠	ugyi
閡	uynw
関	uudi
閣	utkd
閤	uwgk
閥	uwai
閦	uwww
閧	uawi
閨	uffd
閩	uji
閪	usd
閫	ulsi
閬	uyvi
閭	ukkd
閮	utfp
閯	uiit
閰	ued
閱	uwkq
閲	uukq
閳	ulk
閴	umi
閵	uwyd
閶	ujjd
閷	rsuw
閸	ugfg
閹	udjn
閺	ujyi
閻	uqed
閼	uywu
閽	uqaj
閾	uakg
閿	uepc
闀	uawn
闁	uud
闂	uugb
闃	uhdi
闄	usvd
闅	uhhc
闆	ukkk
闇	uujd
闈	unkg
闉	usfd
闊	uitd
闋	uwgd
闌	usld
闍	uftj
闎	urii
闏	uwtj
闐	ufhw
闑	uths
闒	ujnd
闓	umgu
闔	ufcl
闕	uubw
闖	ucoi
闗	uxxo
闘	ugkf
闙	uynt
闚	ughq
闛	uipf
關	uxxg
闝	umti
闞	unbt
闟	uwgn
闠	ukhm
闡	ukkf
闢	unku
闣	uipl
闤	ulge
闥	ufup
闦	umau
闧	ufkp
闬	ufk
闿	umnv
阇	uftj
阓	ukhm
阘	ujnd
阛	ulge
阞	bet
阠	bnfh
阣	btnn
阤	bbn
阥	biy
阦	boy
阧	bufh
阨	bdbn
阩	btah
阫	bdhy
阬	bywn
阭	bcqn
阯	bhg
阰	bxxn
阷	bghg
阸	bynn
阹	bfcy
阺	bqay
阾	bwyc
陁	btbn
陃	bgmw
陊	bqqy
陎	btfy
陏	bdeg
陑	bdmj
陒	bqdb
陓	bdfn
陖	bcwt
陗	bieg
陘	bgva
陙	bdfe
陚	bgay
陜	bdww
陝	bdty
陞	btaf
陠	bsy
陣	blh
陥	bqhj
陦	bdtf
陫	bhdd
陭	bdsk
陮	bwyg
陯	bwga
陰	bwyc
陱	bqoy
陳	bsjg
陸	bfwf
陹	btaj
険	bwgw
陻	bsfg
陼	bftj
陽	bjgr
陾	bdmd
陿	badw
隀	btgf
隁	bajv
隂	bwdy
隃	bwgj
隄	bjgh
隇	bdgv
隉	beag
隊	buey
隌	bujg
階	bxxr
隑	bmgu
隒	buvw
隓	bdaa
隕	bkmy
隖	bqoy
隚	bipf
際	bwfi
隝	bqoy
隞	bgqt
隟	bvjs
隠	bevn
隡	butg
隢	bffq
隣	boqg
隤	bkhm
隥	bwgu
隦	bnku
隨	bdap
隩	btmd
險	bwgw
隫	bfam
隬	bgwr
隭	bfdj
隮	byjg
隯	bfnf
隱	bean
隲	bito
隴	bued
隵	bhga
隷	ffii
隸	sfii
隺	pwyd
隻	wycu
隿	aywy
雂	wyny
雃	gawy
雈	hghy
雊	qkwy
雋	wyhn
雐	hwyd
雑	vswy
雓	wgsy
雔	wywy
雖	kjwy
雗	fjwy
雘	myac
雙	wywc
雚	akky
雛	qbty
雜	ywwy
雝	vkcy
雞	exdy
雟	btwk
雡	nwey
離	yrby
難	akgy
雤	erry
雥	wywy
雦	wywy
雧	wyws
雫	fghu
雬	fsu
雭	fbyu
雮	feb
雰	fwvr
雱	fyr
雲	ffcu
雴	fuf
雵	fmdu
雸	fff
雺	fcnt
電	fjnb
雼	fdf
雽	ftuf
雿	fqiu
霂	fisu
霃	fipq
霅	fyf
霊	ffof
霋	fgvv
霌	fmfk
霐	fixc
霑	fihk
霒	ffcn
霔	fiyg
霕	ffcn
霗	fiwc
霘	fimk
霙	famd
霚	fcnt
霛	fxxx
霝	fkkk
霟	fiaw
霠	fuwn
霡	feyi
霢	fere
霣	fkmu
霤	fqyl
霥	fpfe
霦	fsse
霧	fcne
霨	fnff
霩	fybb
霫	fnrf
霬	flaw
霮	fidn
霯	fwgu
霱	fcnk
霳	fbtg
霴	ffci
霵	fkby
霶	fiyy
霷	fjjr
霺	ftmt
霻	fmau
霼	ffco
霽	fyjf
霿	fcnh
靀	fape
靁	flll
靂	fdth
靃	fwyy
靄	fyjn
靅	ffcm
靆	ffcp
靇	fued
靈	fkkw
靉	ffct
靊	fmdu
靋	fidh
靌	fpgm
靍	fwyo
靎	fqqo
靏	fpwo
靐	flfl
靑	gmhg
靔	gern
靕	ghge
靗	geiq
靘	geqc
靚	gehq
靜	geeh
靝	gero
靟	hdhe
靣	dlkf
靤	dljn
靦	dljq
靧	dljm
靨	djef
靪	afsh
靫	afcy
靬	affh
靭	afvy
靮	afqy
靯	affg
靰	afgq
靱	afvy
靲	afwn
靵	afng
靷	afxh
靸	afby
靹	afmw
靺	afgs
靻	afeg
靽	afug
靾	afan
靿	afxe
鞀	afvk
鞁	afby
鞂	afty
鞃	afxc
鞄	afqn
鞆	afgw
鞇	afld
鞈	afwk
鞉	afqi
鞊	affk
鞌	pvaf
鞎	afvy
鞏	awyf
鞐	afhh
鞓	afkg
鞕	afgr
鞖	afev
鞗	whtf
鞙	afke
鞚	afpa
鞛	afuk
鞜	afij
鞝	afik
鞞	afrf
鞟	afyb
鞡	afru
鞢	afas
鞤	ffff
鞥	afwa
鞦	afto
鞧	afug
鞨	afjn
鞩	afij
鞪	cnhf
鞬	afvp
鞮	afjh
鞰	afjl
鞱	afee
鞳	afak
鞵	afed
鞶	tuwf
鞷	gkmf
鞸	afjg
鞹	afyb
鞺	afif
鞻	aflv
鞼	afkm
鞽	aftk
鞾	afag
鞿	afxw
韀	afoo
韁	afgg
韂	afqy
韃	affp
韄	afac
韅	afjo
韆	afsp
韇	affm
韈	afaw
韉	afao
韊	afal
韋	nkgj
韌	nkgy
韍	nkgy
韎	nkgs
韏	ugng
韐	nkgk
韑	igqg
韒	nkge
韓	fjng
韔	nkge
韕	nkgb
韖	nkgs
韗	nkgl
韘	nkgs
韙	jghg
韚	nkgf
韛	nkge
韜	nkge
韝	nkgf
韞	nkgl
韟	nkgf
韠	nkgg
韡	nkgg
韢	nkgn
韣	nkgj
韤	nkgw
韥	nkgm
韨	fnhy
韮	ahdg
韯	fahg
韰	hqcg
韱	wwag
韲	yhdg
韴	ujgh
韷	ujbm
韸	ujth
韹	ujrg
韺	ujad
韻	ujkm
韼	ujtp
韽	wynj
韾	fnwj
響	xtyj
頀	ujac
頁	dmu
頂	sdmy
頃	xdmy
頄	vdmy
項	admy
順	kdmy
頇	fdmy
須	edmy
頉	hdmy
頊	gdmy
頋	dbdm
頌	wcdm
頍	fcdm
頎	rdmy
頏	ywdm
預	cnhm
頑	fqdm
頒	wvdm
頓	gbnm
頔	mdmy
頕	hkdm
頖	ugdm
頗	bdmy
領	wycm
頙	ghdm
頚	cfdm
頛	fsdm
頜	wgkm
頝	urdm
頞	pvdm
頟	tkdm
頠	qdbm
頡	fkdm
頢	tddm
頣	ahnm
頤	ahkm
頥	hahm
頦	yntm
頧	tndm
頨	ndmy
頩	uadm
頪	odmy
頫	qidm
頬	gudm
頭	gkum
頮	iadm
頯	qadm
頰	dwwm
頱	efdm
頲	tfpm
頳	fodm
頴	xfim
頵	vtkm
頶	tfkm
頷	wynm
頸	gvam
頹	tqdm
頺	tbdm
頻	hhdm
頼	skdm
頽	twdm
頾	edmx
頿	ehxm
顀	wydm
顁	pghm
顂	swwm
顃	oodm
顄	bibm
顅	ynem
顆	jsdm
顇	ywwm
顈	xxim
顉	qdmy
顊	tnfm
顋	lndm
題	jghm
額	ptkm
顎	kkfm
顏	ydem
顐	pldm
顑	dgkm
顒	jmhm
顓	mdmm
顔	utem
顕	jodm
顖	tlrm
顗	mgkm
願	drim
顙	cccm
顚	xhnm
顛	fhwm
顜	amfm
顝	medm
類	oddm
顟	nwem
顠	sfim
顡	uedm
顢	amhm
顣	dhim
顤	fffm
顥	jyim
顦	wyom
顧	ynwm
顨	dmdj
顩	wgkm
顪	hdgm
顫	ylkm
顬	fdmm
顭	alpm
顮	pghm
顯	jxxm
顰	hhdf
顱	hllm
顲	ooym
顳	bbbm
顴	akkm
颋	tfpm
颎	xodm
颒	iadm
颕	xfim
颙	jmhm
颣	oxim
風	wtji
颩	wtje
颪	ghwj
颫	wtjg
颬	wtjt
颭	wtjk
颮	wtjn
颯	uwtj
颰	wtjy
颱	wtjk
颲	wtjj
颳	wtjd
颴	wtjh
颵	wtje
颶	wtjw
颷	wtjo
颸	wtjn
颹	wtjg
颺	wtjr
颻	etfj
颼	wtjc
颽	mgkj
颾	wtjj
颿	cowj
飀	wtjl
飁	nrwj
飂	wtje
飃	wtji
飄	sfij
飅	wtjl
飆	dddj
飇	wtjd
飈	wtjo
飉	wtji
飊	oooj
飋	wtjt
飌	akkj
飍	wtjj
飏	wrnr
飐	wrhk
飔	wrln
飖	etfr
飗	wrql
飛	nurh
飜	tolh
飝	nurh
飠	wvty
飡	uwyv
飢	wvwn
飣	wvsh
飤	wvwy
飥	wvta
飦	wvfh
飩	wvgn
飪	wvtf
飫	wvtd
飬	ugyv
飭	wvte
飮	wyvw
飯	wvrc
飰	wvyh
飱	gqwv
飲	wvqw
飳	wvyg
飴	wvck
飵	wvtf
飶	wvnt
飷	wveg
飸	kgnv
飹	wvqb
飺	hxwv
飻	wvwe
飼	wvnk
飽	wvqn
飾	wvth
飿	wvbm
餀	wvar
餁	wvwf
餂	wvtd
餃	wvur
餄	wvwk
餅	wvua
餆	wvqi
餇	wvmk
餈	uqwv
餉	wvtk
養	ugyv
餋	ugwv
餌	wvbg
餎	wvtk
餏	wvye
餑	wvfb
餒	wvev
餓	wvty
餔	wvsy
餕	wvct
餖	wvgu
餗	wvsk
餘	wvws
餙	wvrh
餚	wvre
餛	wvjx
餜	wvjs
餝	wvay
餞	wvaa
餟	wvcc
餠	wvtf
餡	wvqe
餢	wvuk
餣	wvdn
餤	wvoo
餥	hdhv
餦	wvde
餧	wvtv
館	wvpn
餩	wvww
餪	wvdd
餫	wvpl
餬	wvde
餭	wvrg
餯	wvxe
餰	wvts
餱	wvwd
餲	wvjn
餳	wvjr
餴	wvda
餵	wvle
餶	wvme
餷	wvsg
餸	wvup
餹	wvok
餺	wvsf
餻	wvuo
餼	wvro
餽	wvrc
餾	wvql
餿	wvec
饀	wvee
饁	wvfl
饂	wvjl
饃	wvad
饄	wvif
饅	wvjc
饆	wvjg
饇	wvak
饈	wvug
饉	wvag
饊	wvat
饋	wvkm
饌	wvnw
饍	wvuk
饎	wvfk
饏	nbtv
饐	wvfu
饑	wvxw
饒	wvfq
饓	wvis
饖	wvhh
饗	xtyv
饘	wvyg
饙	wvfm
饚	wval
饛	wvae
饜	djev
饝	wvod
饞	wvqy
饟	wvye
饠	wvly
饡	wvtm
饢	wvge
饤	qnsh
饦	qnta
饳	qnbm
饸	qnwk
饹	qntk
饻	qnye
饾	qngu
馂	qnct
馃	qnjs
馉	qnme
馌	qnfl
馎	qnsf
馚	tjwv
馛	tjdy
馜	tjnx
馝	tjnt
馞	tjfb
馟	tjeb
馠	tjwk
馡	tjhd
馢	tjaa
馣	tjdn
馤	tjjn
馦	tjuw
馧	tjjl
馩	tjfm
馪	tjpm
馫	tjtj
馬	coi
馭	cocy
馮	ucoy
馯	cofh
馰	coqy
馱	cody
馲	cota
馳	cobn
馴	cokh
馵	coaj
馶	cofc
馷	cogh
馸	corh
馹	cojg
馺	coby
馻	cocq
馼	coyy
馽	cokh
馾	copq
馿	coyn
駀	cody
駁	corr
駂	xfco
駃	conw
駄	cody
駅	cony
駆	coar
駇	coty
駈	corg
駉	comk
駊	coby
駋	covk
駌	qbco
駍	cogf
駎	comg
駏	coan
駐	coyg
駑	vcco
駒	coqk
駓	codg
駔	coeg
駕	ekco
駖	cowc
駗	cowe
駘	cock
駙	cowf
駚	comd
駛	cokr
駜	cont
駝	copx
駞	cotb
駟	colg
駠	coqb
駡	kkco
駢	coua
駣	coqi
駤	cogf
駥	coad
駦	ugco
駧	comk
駨	coqj
駩	cowg
駪	cotq
駫	coiq
駬	cobg
駭	coyw
駮	cour
駯	cotf
駰	cold
駱	cotk
駲	coyh
駳	cotp
駴	coaa
駵	cogn
駶	conk
駷	cosk
駸	covc
駹	cody
駺	coyv
駻	cojf
駼	cows
駽	coke
駾	couq
駿	coct
騀	coty
騁	comn
騂	couh
騃	cocd
騄	covi
騅	cowy
騆	comk
騇	cowk
騈	cotf
騉	cojx
騊	coqb
騋	cosw
騌	copi
騍	cojs
騎	codk
騏	codw
騐	cown
騑	cohd
騒	cocj
験	coww
騔	cojn
騕	cosv
騖	cnho
騗	ynmo
騘	coqn
騙	coya
騚	couj
騛	conh
騜	corg
騝	covp
騞	codd
騟	cowj
騠	cojh
騡	cori
騢	conc
騣	cort
騤	cowd
騥	cocs
騦	coln
騧	comk
騨	coif
騩	corc
騪	coec
騫	pawo
騬	cotx
騭	bhho
騮	coql
騯	coyy
騰	eugo
騱	coed
騲	coaj
騳	coco
騴	cojv
騵	codi
騶	coqt
騷	cocj
騸	coyn
騹	coag
騺	fufo
騻	codr
騼	coox
騽	conr
騾	coli
騿	couj
驀	ajdo
驁	gqto
驂	coce
驃	cosi
驄	cotn
驅	coak
驆	cojg
驇	fwfo
驈	cock
驉	coho
驊	coag
驋	cowc
驌	covj
驍	cofq
驎	coog
驏	conb
驐	coyt
驑	cogl
驒	cokf
驓	couj
驔	cosj
驕	cotk
驖	cofg
驗	coww
驘	yecy
驙	coyg
驚	aqko
驛	colf
驜	coof
驝	cofs
驞	copm
驟	cobi
驠	coao
驡	uego
驢	cohl
驣	couo
驤	coye
驥	couw
驦	cofh
驧	coao
驨	comk
驩	coay
驪	cogx
驫	coco
驲	cgjg
骃	cgld
骉	cgcg
骍	cguh
骎	cgvc
骔	cgpi
骕	cgvw
骙	cgwd
骦	cgfh
骩	mevn
骪	mewy
骫	mevy
骬	megf
骭	mefh
骮	meay
骯	meyw
骲	meqn
骳	meby
骴	mehx
骵	mesg
骹	meur
骻	medn
骽	meev
骾	megr
骿	meua
髃	mejy
髄	medp
髆	mesf
髇	meyk
髈	meyy
髉	mepy
髊	meua
髍	meos
髎	mene
髏	melv
髐	mefq
髒	meaa
體	memu
髕	mepm
髖	mepy
髗	mehl
髙	yjfk
髚	ymkw
髛	ymkv
髜	ymka
髝	ymke
髞	ymks
髠	dewb
髢	debb
髣	deyr
髤	desu
髥	demf
髧	depq
髨	defq
髩	degn
髪	dedc
髬	dedg
髮	dedy
髰	dean
髱	deqn
髲	debu
髳	dect
髴	dexj
髵	dedj
髶	debf
髷	dema
髸	deaw
髺	detd
髼	deth
髽	dewf
髾	deie
髿	deit
鬀	deut
鬁	detj
鬂	derw
鬄	dejr
鬅	deee
鬆	desc
鬇	deqh
鬉	dert
鬊	dedj
鬋	deuj
鬌	dede
鬍	dede
鬎	desj
鬐	defj
鬑	deuw
鬒	defw
鬔	detp
鬕	dead
鬖	dece
鬗	deay
鬘	dejc
鬙	deuj
鬚	deem
鬛	deln
鬜	deue
鬝	deuj
鬞	deme
鬠	dewj
鬡	deps
鬢	depm
鬤	deye
鬥	hggh
鬦	hggf
鬧	hggh
鬨	hggw
鬩	hggq
鬪	hggf
鬫	hggt
鬬	hggr
鬭	hggr
鬮	hggx
鬰	srre
鬱	stfe
鬳	hgkh
鬴	gkms
鬵	aqah
鬶	gmqh
鬷	gkmt
鬸	gkml
鬹	ghqh
鬺	gkmr
鬽	rqce
鬾	rqcc
鬿	rqcr
魀	rqcj
魆	rqcn
魊	rqcg
魋	rqcy
魌	rqcw
魎	rqcy
魐	rqcw
魒	rqci
魓	rqcg
魕	rqcw
魖	rqco
魗	fnac
魘	djec
魙	ilrc
魚	qou
魛	qovt
魜	qowy
魝	qojh
魞	qoty
魟	qoag
魠	qota
魡	qoqy
魢	qonn
魣	qoch
魤	qowx
魥	qoby
魦	qoit
魧	qoyw
魨	qogn
魩	qoqr
魪	qowj
魫	qopq
魬	qorc
魭	qofq
魮	qoxx
魯	qojf
魰	qoyy
魱	qogx
魲	qoyn
魳	qogh
魴	qoyt
魵	qowv
魶	qomw
魷	qody
魸	qotn
魹	qoen
魺	qosk
魻	qolh
魼	qofc
魽	qofg
魾	qodg
魿	qowc
鮀	qopx
鮁	qody
鮂	qolw
鮃	qogf
鮄	qoxj
鮅	qont
鮆	hxqo
鮇	qofy
鮈	qoqk
鮉	qovk
鮊	qorg
鮋	qomg
鮌	qoyx
鮍	qoby
鮎	qohk
鮏	qotg
鮐	qock
鮑	qoqn
鮒	qowf
鮓	qotf
鮔	qoan
鮕	qodg
鮖	qodg
鮗	qotu
鮘	qowy
鮙	qong
鮚	qofk
鮛	qohi
鮜	qork
鮝	ugqo
鮞	qodj
鮟	qopv
鮠	qoqb
鮡	qoqi
鮢	qotf
鮣	qoqb
鮤	gqjo
鮥	qotk
鮦	qomk
鮧	qogw
鮨	qoxj
鮩	qoua
鮪	qode
鮫	qour
鮬	qodn
鮭	qoff
鮮	qouh
鮯	qowk
鮰	qolk
鮱	qofx
鮲	qowd
鮳	qofn
鮴	qows
鮵	qouq
鮶	qovk
鮷	qout
鮸	qoqq
鮹	qoie
鮺	uqou
鮻	qoct
鮼	qovc
鮽	qows
鮾	qoev
鮿	qobn
鯀	qoti
鯁	qogr
鯂	qosg
鯃	qogk
鯄	qogy
鯅	qotp
鯆	qosy
鯇	qopq
鯈	whto
鯉	qojf
鯊	iito
鯋	qoit
鯌	qotk
鯍	qoyk
鯎	qodn
鯏	qotj
鯐	qofh
鯑	qorh
鯒	qoce
鯓	qott
鯔	qovl
鯕	qodw
鯖	qoge
鯗	ugqo
鯘	qotv
鯙	qoyb
鯚	qotb
鯛	qomk
鯜	qouv
鯝	qold
鯞	qovh
鯟	qosj
鯠	qosw
鯡	qohd
鯢	qoeq
鯣	qojr
鯤	qojx
鯥	qoff
鯦	qotk
鯧	qojj
鯨	qoyi
鯩	qowa
鯪	qoft
鯫	qobc
鯬	tqto
鯭	qobl
鯮	qopi
鯯	qotj
鯰	qown
鯱	qohw
鯲	qoyu
鯳	qooy
鯴	qonj
鯵	qoce
鯶	qopl
鯷	qojh
鯸	qowd
鯹	qojg
鯺	qofj
鯻	qosj
鯼	qort
鯽	qovb
鯾	qowr
鯿	qoya
鰀	qoec
鰁	qori
鰂	qomj
鰃	qole
鰄	qodv
鰅	qojy
鰆	qodj
鰇	qocs
鰈	qoas
鰉	qorg
鰊	qosl
鰋	qoav
鰌	qoug
鰍	qoto
鰎	qovp
鰏	qogl
鰐	qokn
鰑	qojr
鰒	qott
鰓	qoln
鰔	qodk
鰕	qonc
鰖	qode
鰗	qode
鰘	qopf
鰙	qoak
鰚	qopg
鰛	qojl
鰜	qouw
鰝	qoyk
鰞	qoqo
鰟	qoyy
鰠	qocj
鰡	qoql
鰢	qoco
鰣	qojf
鰤	qoth
鰥	qoli
鰦	qoux
鰧	eugo
鰨	qojn
鰩	qoeb
鰪	qofl
鰫	qopk
鰬	qohy
鰭	qofj
鰮	qoll
鰯	qoxu
鰰	qoph
鰱	qolp
鰲	gqto
鰳	qoae
鰴	tmgt
鰵	txto
鰶	qowi
鰷	qows
鰸	qoak
鰹	qoaf
鰺	qoce
鰻	qojc
鰼	qonr
鰽	qogj
鰾	qosi
鰿	qogm
鱀	vaqo
鱁	qogp
鱂	qouf
鱃	qoug
鱄	qogf
鱅	qooh
鱆	qouj
鱇	qooi
鱈	qofv
鱉	itqo
鱊	qock
鱋	qoho
鱌	qoqe
鱍	qowc
鱎	qotk
鱏	qosj
鱐	qovj
鱑	qoaw
鱒	qouf
鱓	qokf
鱔	qouk
鱕	qotl
鱖	qodw
鱗	qoog
鱘	qovf
鱙	qofq
鱚	qofk
鱛	qouj
鱜	qoxb
鱝	qofm
鱞	qole
鱟	erro
鱠	qowj
鱡	qomd
鱢	qoks
鱣	qoyg
鱤	qodn
鱥	qohh
鱦	qoxg
鱧	qomu
鱨	qoij
鱩	qofl
鱪	qojj
鱫	qoet
鱬	qofj
鱭	qoyj
鱮	qoew
鱯	qoac
鱰	qolj
鱱	qody
鱲	qovn
鱳	qors
鱴	qoaw
鱵	qotk
鱶	qouv
鱷	qogk
鱸	qohl
鱹	qoay
鱺	qogx
鱻	qoqo
鱽	qgvt
鱾	qgnn
鲀	qggn
鲃	qgcn
鲄	qgsk
鲉	qgmg
鲊	qgtf
鲌	qgrg
鲏	qgby
鲓	qgfn
鲖	qgmk
鲗	qgmj
鲘	qgrk
鲙	qgwc
鲝	uqgf
鲪	qgvk
鲬	qgce
鲯	qgdw
鲹	qgce
鲾	qggl
鲿	qgic
鳀	qgjh
鳁	qgjl
鳂	qgle
鳈	qgri
鳉	qguf
鳑	qgyy
鳒	qguw
鳚	qgnf
鳛	qgnr
鳠	qgac
鳡	qgdn
鳣	qgyg
鳤	qgtn
鳥	qoi
鳦	qonn
鳧	qowb
鳨	qoet
鳩	vqoy
鳪	hqoy
鳫	dqoi
鳬	qwb
鳭	vqoy
鳮	cqoy
鳯	wqoi
鳰	tyqo
鳱	fqoy
鳲	nqoy
鳳	wgqo
鳴	kqoy
鳵	nfqo
鳶	ayqo
鳷	fcqo
鳸	ynqo
鳹	wyno
鳺	gqoy
鳻	wvqo
鳼	yqoy
鳽	gaqo
鳾	gmho
鳿	gqoy
鴀	dhqo
鴁	tdqo
鴂	nwqo
鴃	qonw
鴄	aqqo
鴅	myqo
鴆	pqqo
鴇	xfqo
鴈	dwqo
鴉	ahto
鴊	ghqo
鴋	yqoy
鴌	gdqo
鴍	yqou
鴎	arqo
鴏	qowy
鴐	ekqo
鴑	vcqo
鴒	wyco
鴓	ntqo
鴔	tpqo
鴕	qopx
鴖	naqo
鴗	uqoy
鴘	caqo
鴙	tdqo
鴚	qosk
鴛	qbqo
鴜	hxqo
鴝	qkqo
鴞	kgno
鴟	qayo
鴠	jgqo
鴡	egqo
鴢	xeqo
鴣	dqoy
鴤	qotu
鴥	qopw
鴦	mdqo
鴧	pwqo
鴨	lqoy
鴩	tgqo
鴪	pwqo
鴫	lqoy
鴬	ipqo
鴭	tnqo
鴮	dfno
鴯	dmjo
鴰	tdqo
鴱	arqo
鴲	xjqo
鴳	pvqo
鴴	tgso
鴵	qiqo
鴶	fkqo
鴷	gqjo
鴸	tfqo
鴹	uqoy
鴺	gxwo
鴻	iaqo
鴼	qotk
鴽	vkqo
鴾	ctgo
鴿	wgko
鵀	wtfo
鵁	urqo
鵂	wsqo
鵃	tuqo
鵄	gcfo
鵅	tkqo
鵆	tqos
鵇	tgqo
鵈	bqoy
鵉	yoqo
鵊	dwwo
鵋	nnqo
鵌	qows
鵍	pfqo
鵎	evqo
鵏	sqoy
鵐	awwo
鵑	keqo
鵒	wwko
鵓	fpbo
鵔	qoct
鵕	cwto
鵖	vqoy
鵗	rdmo
鵘	vtko
鵙	mqoy
鵚	twqo
鵛	gvao
鵜	uxho
鵝	trno
鵞	trno
鵟	qtgo
鵠	tfko
鵡	gaho
鵢	tmdo
鵣	skqo
鵤	qeqo
鵥	ugjo
鵦	qovi
鵧	uaqo
鵨	wfko
鵩	ebco
鵪	djno
鵫	hjqo
鵬	eeqo
鵭	qqoy
鵮	qeqo
鵯	rtfo
鵰	mfko
鵱	fwfo
鵲	ajqo
鵳	yneo
鵴	qoqo
鵵	qkqo
鵶	gfgo
鵷	pqbo
鵸	dsko
鵹	tqto
鵺	ywto
鵻	qowy
鵼	pwao
鵽	ccco
鵾	jxxo
鵿	qoja
鶀	qodw
鶁	yiqo
鶂	eqqo
鶃	qoeq
鶄	geqo
鶅	vlqo
鶆	swwo
鶇	sjqo
鶈	gvho
鶉	ybqo
鶊	ovwo
鶋	ndqo
鶌	nbmo
鶍	jqro
鶎	pfio
鶏	egqo
鶐	sypo
鶑	ooqo
鶒	skeo
鶓	alqo
鶔	cnho
鶕	ujqo
鶖	toqo
鶗	jgho
鶘	deqo
鶙	yupo
鶚	kkfo
鶛	xxro
鶜	acno
鶝	gklo
鶞	rfho
鶟	pwdo
鶠	ajvo
鶡	jqwo
鶢	egdo
鶣	ynmo
鶤	plqo
鶥	nhqo
鶦	deqo
鶧	amdo
鶨	xeqo
鶩	cnho
鶪	hdqo
鶫	slqo
鶬	wyvo
鶭	xyqo
鶮	ymko
鶯	oopo
鶰	kmqo
鶱	pawo
鶲	wcno
鶳	qoth
鶴	pwyo
鶵	qbto
鶶	ovho
鶷	pdho
鶸	xuxo
鶹	qyvo
鶺	iweo
鶻	meqo
鶼	uvjo
鶽	wyfo
鶾	fjwo
鶿	uxxo
鷀	uxxo
鷁	uwlo
鷂	etfo
鷃	jpvo
鷄	exdo
鷅	ssqo
鷆	xhno
鷇	fpgc
鷈	qorw
鷉	rhwo
鷊	gkmo
鷋	awgo
鷌	qoco
鷍	thso
鷎	rdfo
鷏	fhwo
鷐	jdfo
鷑	tuqo
鷒	gjho
鷓	oaoo
鷔	gqto
鷕	kwyo
鷖	atdo
鷗	akko
鷘	skto
鷙	fufo
鷚	nweo
鷛	oveo
鷜	lvqo
鷝	jago
鷞	drro
鷟	ytto
鷠	qoqo
鷡	tglo
鷢	dubo
鷣	sjqo
鷤	kkjo
鷥	xxio
鷦	wyoo
鷧	fpgo
鷨	agao
鷩	itqo
鷪	hhpo
鷫	vfjo
鷬	amwo
鷭	tolo
鷮	tdko
鷯	dujo
鷰	akuo
鷱	thio
鷲	yido
鷳	ueqo
鷴	usqo
鷵	nfto
鷶	lmqo
鷷	usgo
鷸	cnho
鷹	owwo
鷺	khto
鷻	qoyt
鷼	ujqo
鷽	erro
鷾	ujno
鷿	nkuo
鸀	lqjo
鸁	yeqy
鸂	iexo
鸃	qouy
鸄	ryto
鸅	lfuo
鸆	hkgo
鸇	ylko
鸈	oufo
鸉	sjgo
鸊	nkuo
鸋	pnlo
鸌	qoac
鸍	gwmo
鸎	mmqo
鸏	apfo
鸐	nwyo
鸑	qtyo
鸒	egno
鸓	lllo
鸔	qoji
鸕	hllo
鸖	fwyo
鸗	uego
鸘	fsho
鸙	wgko
鸚	mmvo
鸛	akko
鸜	hhwo
鸝	gmyo
鸞	yxxo
鸤	nqgg
鸧	wbqg
鸮	kgng
鸰	wycg
鸴	ipqg
鸻	tgsg
鸼	tuqg
鹀	awwg
鹍	jxxg
鹐	qeqg
鹒	ovwg
鹓	pqbg
鹔	vhjg
鹖	jqwg
鹙	toqg
鹝	gkmg
鹟	wcng
鹠	qyvg
鹡	iweg
鹢	uwlg
鹥	atdg
鹮	lgkg
鹯	ylkg
鹲	apfg
鹴	fshg
鹵	hlou
鹶	hlon
鹷	hloc
鹸	hlow
鹹	hlok
鹺	hloa
鹻	hlow
鹼	hlow
鹽	ahnl
麀	oxxx
麁	qoxx
麃	oxxo
麄	wvox
麅	oxxn
麆	oxxg
麉	ffox
麊	ooxx
麌	oxxd
麍	oxxk
麎	oxxe
麏	oxxk
麐	oxxk
麑	oxxq
麔	oxxk
麕	oxxt
麖	oxxi
麗	gmyx
麘	oxxj
麙	oxxk
麚	oxxc
麛	oxxb
麜	oxxs
麞	oxxj
麠	oxxg
麡	oxxj
麢	oxxk
麣	oxxt
麤	oxxx
麥	swwq
麧	swwn
麨	swwt
麩	swwg
麪	swwn
麫	swwn
麬	swwb
麭	swwn
麮	swwc
麯	swwa
麰	swwg
麱	swws
麲	swwq
麳	swww
麵	swwf
麶	swwc
麷	swwu
麹	gqqo
麺	gqdf
麼	ossx
麿	ossk
黀	ossc
黁	ossj
黂	ossm
黃	agmw
黅	amwn
黆	amwq
黇	amwk
黈	amwg
黊	amwf
黋	igqw
黌	errw
黐	twic
黒	jfou
黓	lfoy
黕	lfoq
黖	lfoq
黗	lfon
黙	jfdo
黚	lfof
點	lfok
黡	ddlo
黣	lfox
黤	lfon
黦	lfob
黨	ipko
黫	lfof
黬	lfok
黭	lfoa
黮	lfon
黰	lfow
黱	eugo
黲	lfoe
黳	atdo
黴	tmgt
黵	lfoy
黶	djeo
黷	lfom
黸	lfol
黺	oiwv
黽	xnng
黿	fqxf
鼀	fwxf
鼁	fcxf
鼂	jgxf
鼃	ffxf
鼄	tfxf
鼅	tdkx
鼆	pjux
鼇	gqtx
鼈	itxf
鼉	kklx
鼊	nkux
鼌	jgkn
鼏	phnn
鼑	hhnn
鼒	fthn
鼔	fkuc
鼕	fkuu
鼖	fafc
鼘	fkug
鼚	fkue
鼛	fkuk
鼜	fkuj
鼝	ijgc
鼞	fkuf
鼟	fkuu
鼡	iwgj
鼣	enud
鼤	enuy
鼥	enuy
鼦	enuk
鼧	enux
鼨	enuu
鼩	enuk
鼪	enug
鼫	enud
鼭	enuf
鼮	enup
鼰	enum
鼱	enue
鼲	enul
鼳	enud
鼴	enuv
鼵	enud
鼶	enuw
鼸	enuw
鼺	enul
鼼	thlh
鼿	thlq
齀	thly
齁	thlk
齂	thli
齃	thln
齅	thld
齆	thlc
齇	thlg
齈	thle
齉	thle
齊	yjf
齋	yjiu
齌	yjou
齍	yjlf
齎	yjmu
齏	yjhg
齒	hbj
齓	hbnn
齔	hbxn
齕	hbtn
齖	hbat
齗	hbrh
齘	hbwj
齙	hbqn
齚	hbtf
齛	hban
齜	hbhx
齝	hbck
齞	hbkw
齟	hbeg
齠	hbvk
齡	hbwc
齢	hobc
齣	hbqk
齤	ughb
齥	hbjt
齦	hbvy
齧	dhvb
齨	hbeg
齩	hbur
齪	hbkh
齫	hbls
齬	hbgk
齭	hbrr
齮	hbdk
齯	hbeq
齰	hbaj
齱	hbbc
齲	hbty
齳	hbpl
齴	hbue
齵	hbjy
齶	hbkn
齷	hbnf
齸	hbul
齹	uahb
齺	hbqt
齻	hbfw
齼	hbsh
齽	hbsi
齾	hgkb
龁	hwbn
龂	hwbr
龍	uegd
龎	dued
龏	uega
龐	oued
龑	uegd
龒	uegi
龓	deud
龔	uegw
龕	wgkd
龖	uegd
龗	fkkd
龘	uegd
龜	txd
龝	ttxg
龞	ittx
龡	wgkw
龢	wgkt
龣	wgki
龤	wgkr
龥	wgkm
﨎	ywyc
﨏	fwwk
﨑	mukh
﨓	sawf
﨔	sigr
﨟	aejn
﨡	jtgg
﨣	fhuf
﨤	byyp
﨧	qftb
﨨	qfuf
﨩	bqmh
	rtt
	dgt
	ttg
	nnll
	nnll
	wqbt
	wqvg
	qtn
	bnn
	cny
	kkmw
	kunt
	kunt
	ihyt
	nhty
	nqbt
	nqvg
	rtgt
	rmry
	rian
	rwyc
	rccy
	gggg
	aghg
	smry
	gqkm
	idpy
	tfd
	dwi
	ipb
	nhd
	hovg
	tcde
	ttgy
	xmg
	ptnb
	uytt
	ugf
	fai
	fslx
	fslc
	vhgd
	efny
	apwe
	pukm
	pukm
	ugi
	yrh
	yako
	mgeg
	mgeg
	khf
	qynn
	qaht
	qnty
	qynn
	qafj
	quuk
	qhhc
	uwwf
	uqvh
	uwwf
	uqvh
	fjj
	oopb
	hqgt
	qgqb
	qgdj
	qgug
	hqot
	eugg
	gmhg
	urqg
	gqjg
	geqg
	hdqg
	rhwg
	nkug
	dxyd
	yxxy
郎	yvbh
凉	uyiy
秊	ttfj
裏	yjfe
隣	boqg
兀	gqv
嗀	fpgc
礼	finn
蘒	attx
